*pl	MARC Country Code
	xx#
-	xx#
[-]	xx#
[? Fuente]	cl#
[.n.p.]	xx#
10-12 Picton Street, Bristol BS6 5QA, UK	enk
1926	xx#
1965	xx#
1992	xx#
1994	xx#
1995	xx#
1996	xx#
1998	xx#
2 rue des Charmilles, 35510, Cesson-Se^avigne^a Broche^a, France	xx#
2000	xx#
2001	xx#
2003	xx#
2005	xx#
2006	xx#
37 :68-70	xx#
3A DeMontfort St., Leicester LE1 7HD	enk
4295 Walnut Blvd., Walnut Creek, CA 94596	cau
45(5) :46-66, ill., map	xx#
5(9) :17-19, ill.	xx#
6742, rue Saint-Denis, Montre^aal, Que^abec, Canada H2S 2S2	quc
7 :8-9, ill.	xx#
7186 Pine Bluff Drive, Lake Worth, FL 33467	flu
750 West Diamond, Suite 200, Anchorage, AK 99515	aku
8(7) :480-486, ill., map	xx#
812 :12-23, tables	xx#
A^obo	fi#
A^obo, Finland	fi#
A^Olesund, Norway	no#
A^Orhus	dk#
A^orhus, Denmark	dk#
A^Os (Norway)	no#
A^Osa	sw#
A.C.T.	aca
Aachen	gw#
Aachen, Germany	gw#
Aalborg	dk#
Aalborg O^zst	dk#
Aalborg, Denmark	dk#
Aarau	sz#
Aarhus	dk#
Aarhus and Copenhagen	dk#
Aarhus, Denmark	dk#
(Aarhus)	dk#
Aasiaat	dk#
Abakan	ru#
Abashiri, Japan	ja#
Aberdeen	stk
Aberdeen, Scotland	stk
[Aberdeen]	stk
Abernyte, Scotland	stk
Aberystwyth	wlk
Aberystwyth, Wales	wlk
Abingdon	enk
Abisko	sw#
Abisko, Sweden	sw#
Ada, MI	miu
Ada, OH	ohu
Adam Kraft Verlag	gw#
Adelaide	xra
Adelaide, SA	xra
(Adelaide)	xra
Agincourt	fr#
Ainola, Finland	fi#
Air Research and Development Command	mau
Aix en Provence, France	fr#
[Aix en Provence]	fr#
Aix-en-Provence	fr#
Aix-en-Provence, France	fr#
AK	aku
Akaska	aku
Akhangel'sk	ru#
Akita, Japan	ja#
[Aklavik, NT]	ntc
Aklavik, NWT	ntc
Akron, OH	ohu
[Akureyi, Iceland]	ic#
Akureyr	ic#
Akureyri	ic#
Akureyri, Iceland	ic#
(Akureyri)	ic#
[Akureyri]	ic#
AL	alu
Alabama	alu
Alaska	aku
Alaska, Fairbanks	aku
[Alaska]	aku
Albany	nyu
Albany, NY	nyu
Albany, NZ	nz#
Albany, WA	wau
Albany, Western Australia	wea
Alberta	abc
Albertslund	dk#
Albertslund, Denmark	dk#
Albuquerque	nmu
Albuquerque, NM	nmu
Albuquerque, NM and Livermore, CA	nmu
Alcanar	sp#
Alcanar, Spain	sp#
Aldburgh	enk
Alderley Edge	enk
Aldershot	enk
Aldershot, England	enk
Aldershot, UK	enk
Alderwood Manor, Washington	wau
Alenc^con	fr#
Alexandria VA	vau
Alexandria, NSW	xna
Alexandria, USA	vau
Alexandria, VA	vau
Alexandria, Virginia	vau
Alfreton	enk
Algiers	ae#
Alingsa^os, Sweden	sw#
Aliso Viejo, CA	cau
Alkmaar	ne#
Allen & Unwin	xx#
Alma-Ata	kz#
Almaty	kz#
Alphen aan den Rijn	ne#
Alta	no#
Alta, Norway	no#
Alta, UT	utu
Altamonte Springs, FL	flu
Altdorf	sz#
Altenburg	gw#
Altenburg, Germany	gw#
Altona	gw#
Altona, Man.	mbc
Altona, VIC	vra
Amagansett, NY	nyu
Ambleside	enk
Ambleside, Cumbria	enk
Ambleside, Westmorland	enk
Amersham, UK	enk
Ames	iau
Ames, IA	iau
Ames, Iowa	iau
Amherst, MA	mau
Amherst, Massachusetts	mau
Amherst, New York	nyu
Amherst, USA	nyu
Amstelodami [Amsterdam]	ne#
Amsterdam	ne#
(Amsterdam )	ne#
Amsterdam and New York	ne#
Amsterdam, etc.	ne#
Amsterdam, Holland	ne#
Amsterdam, Netherlands	ne#
[Amsterdam, Netherlands]	ne#
Amsterdam, Netherllands	ne#
Amsterdam, The Netherlands	ne#
[Amsterdam?]	ne#
(Amsterdam)	ne#
[Amsterdam]	ne#
Amsterdami	ne#
Amundsen-Scott, Antarctica	ay#
Anacostia, D.C.	xxu
Anadyr	ru#
Anchorage	aku
Anchorage, AK	aku
Anchorage, AK, USA	aku
Anchorage, AK.	aku
[Anchorage, AK]	aku
Anchorage, AL	aku
Anchorage, Alaska	aku
[Anchorage, Alaska]	aku
Anchorage, USA	aku
Anchorage)	aku
[Anchorage]	aku
Ancona	it#
Andover	enk
Andover, MA	mau
Angers	fr#
Ann Arbor	miu
Ann Arbor, MI	miu
[Ann Arbor, MI]	miu
Ann Arbor, Michgan	miu
Ann Arbor, Michigan	miu
[Ann Arbour, MI]	miu
Annandale, NSW	xna
Annapolis	ma#
Annapolis, MA	mau
Annapolis, Maryland	mdu
Annapolis, MD	mdu
Annapolis, MD, USA	mdu
[Annapolis, MD]	mdu
Annapolis, USA	mdu
Annzola d'Ossola, Italy	it#
Ansan, Korea	ko#
Antarctic	ay#
Antarctica	ay#
(Antarktika)	ay#
Antibes	fr#
Antofagasta, Chile	cl#
Antony, France	fr#
Antwerp	be#
Antwerp-Stavanger	be#
Antwerp, Netherlands	be#
(Antwerp)	be#
Antwerpen	be#
Antwerpen, Belgium	be#
Anvers	be#
(Anvers)	be#
Anzac Parade, Kensington	xna
Apatity	ru#
[Apopka, FL]	flu
Apple Valley, MN	mnu
Arabba di Livinallongo (Belluno)	it#
Arabba, Italy	it#
Aranda, ACT	aca
Arbois, France	fr#
Archangel'sk	ru#
Arctic Institute of North America	cau
Ardingly, England	enk
Ardsley, NY	nyu
Arendal, Norway	no#
Argentina	ag#
(Argentina)	ag#
Arjeplog	sw#
Arjeplog, Sweden	sw#
Arkhangel'sk	ru#
(Arkhangel'sk)	ru#
Arkhangelsk	ru#
Arktisk Institut	dk#
Arles	fr#
Arles, France	fr#
Arlington	xxu
Arlington VA	vau
Arlington, MA	mau
Arlington, VA	vau
Arlington, Va.	vau
[Arlington, VA]	vau
Arlington, Virginia	vau
[Arlo^uv], Sweden	sw#
Armagh, Ireland	ie#
Armidale, NSW	xna
[Armidale, Queensland]	qea
Armonk, USA	nyu
Arnhem	ne#
Arvidsjaur, Sweden	sw#
Aschehoug, Norway	no#
Ashbourne, England	enk
Asheville	ncu
Asheville NC, USA	ncu
Asheville, NC	ncu
Ashland, OR	oru
Ashland, Wisconsin	wiu
Asker, Norway	no#
Askov, Denmark	dk#
Assen	ne#
Assen, Netherlands	ne#
(Asuncio^an)	py#
Atglen, PA	pau
Athabasca	abc
Athens, GA	gau
Athens, Georgia	gau
Athens, OH	ohu
Athy	ie#
Athy, Co. Kildare	ie#
Athy, Ireland	ie#
Atlanta	gau
Atlanta, GA	gau
[Atlanta, GA]	gau
Atlanta, Georgia	gau
Atlantic City Airport, NJ	nju
Atlantic Highlands, NJ	nju
Aubie^gre	fr#
Auburn	alu
Auckland	nz#
Auckland,	nz#
Auckland, Christchurch, etc.	nz#
Auckland, N.Z.	nz#
Auckland, New Zealand	nz#
(Auckland, New Zealand)	nz#
Auckland, NZ	nz#
(Auckland)	nz#
[Auckland]	nz#
Augsburg	gw#
Augusta, GA	gau
(Augusta, Maine)	meu
Auke Bay, AK	aku
Aukland	nz#
Aurora, IL	ilu
Aurora, MO	mou
Austin, TX	txu
Australia	at#
(Australia)	at#
Australian	at#
Avignon	fr#
Ayer, MA	mau
Aylesbury	enk
Aylesbury, Bucks.	enk
Azusa, CA	cau
Ba^hle	sz#
Baarn	ne#
Baarn, Netherlands	ne#
Bad Du^urcheim	gw#
Bad Durkheim, Germany	gw#
Bad Godesberg	gw#
(Bad Godesberg)	gw#
Bad Vilbel	gw#
Badajoz	sp#
Baden	gw#
Baden-Baden, Germany	gw#
(Baden)	gw#
Badminton	enk
Bagneau	fr#
Bagradin	ru#
Bagsvaerd, Denmark	dk#
Bahi^aa Blanca	ag#
Bahi^aa Blanca, Argentina	ag#
Bahi^aa Blance	ag#
Bahia Bianca	ag#
Baker Lake, NTW	nbc
Baker Lake, NWT	nbc
Baku	aj#
Baldock	enk
Ballerup	dk#
Ballerup, Denmark	dk#
Balmain, NSW	xna
Baltimore	mdu
Baltimore, Maryland	mdu
Baltimore, MD	mdu
[Baltimore, MD]	mdu
(Baltimore)	mdu
Bamberg	gw#
Banchory, Kincardineshire	stk
Banff	abc
Banff, Alberta, Canada	abc
Banff, Alta	abc
Bangalore	ii#
Bangor	wlk
Bangor, Maine. U.S.A.	meu
Bangor, Northern Island	wlk
Banstead	enk
Banstead, UK	enk
Banyuls-sur-Mer	fr#
Barbizon	fr#
Barbizon, France	fr#
Barby	enk
Barcelona	sp#
Barcelona, Spain	sp#
Barlin	gw#
Barmouth, England	enk
Barnaul	ru#
Barnsley	enk
Barnsley, South Yorkshire	enk
(Barnston, Lancashire)	enk
Barre, MA	mau
Barreiro y Ramos S.A.	po#
Barrow	aku
Barrow, AK	aku
[Barrow, AK]	aku
Barrow, Alaska	aku
Barrow, Alaska 1992	aku
[Barrow]	aku
Basel	sz#
Basel and Stuttgart	sz#
(Basel, New York)	sz#
Basel, Switzerland	sz#
(Basel)	sz#
Basil	sz#
Basileae	sz#
Basingstoke	enk
Basingstoke, England	enk
Bath	enk
Bath, England	enk
Bathurst, NSW	xna
Batley, England	enk
Baulkham Hills, NSW	xna
Bay St. Louis, MI	mou
Bayonne, France	fr#
Bayreuth	gw#
BC	bcc
Beaconsfield	enk
[Beaconsfield]	enk
Beau Bassin, Mauritius	mf#
Beauceville, Que^abec	quc
Beaumont, TX	txu
Beaver Island, Falkland Islands	fk#
Beaverton, Ont.	onc
Beckenham	enk
Beckenham, Kent	enk
(Beckman Instruments Inc.)	xx#
Bedford	enk
Bedford Park	xra
Bedford Park, South Australia	xra
Bedford, MA	mau
Bedford, Massachusetts	mau
Bedford, NS	nsc
Beersheva, Israel	is#
Beijing	cc#
Beijing, China	cc#
(Beijing)	cc#
[Beijing]	cc#
Belconnen, ACT	aca
Belconnen, Australia	aca
Belfast	nik
[Belfast]	nik
Belgium	be#
Belle-Ile-en-Mer, France	fr#
Belleville, IL	ilu
Bellevue, WA	wau
Bellingham, WA	wau
Bellingham, Washington; Prague	wau
Belmont, California, USA	cau
Belo Horizonte	bl#
[Belrock]	xx#
Beltsville, MD	mdu
(Bengal)	bg#
Beograd	rb#
Bergamo	it#
(Bergamo)	it#
Bergen	no#
Bergen, Norway	no#
Bergen?	no#
(Bergen)	no#
[Bergen]	no#
Bergisch Gladbach	gw#
Berkeley	enk
Berkeley and Los Angeles	enk
Berkeley and Los Angeles, CA	enk
Berkeley CA	cau
Berkeley Heights, NJ	nju
Berkeley Heights, NJ, USA	nju
Berkeley, CA	cau
Berkeley, CA.	cau
(Berkeley, CA)	cau
[Berkeley, CA]	cau
Berkeley, Calif.	cau
Berkeley, California	cau
(Berkeley, California)	cau
Berkeley, USA	cau
(Berkeley)	enk
[Berkeley]	enk
Berkhamsted	enk
Berkley, CA	cau
Berlin	gw#
Berlin-Schoneberg	gw#
Berlin, etc.	gw#
(Berlin)	gw#
[Berlin]	gw#
Berlin/London	gw#
Berling	gw#
Bern	sz#
Bern und Tu^ubingen	sz#
(Bern)	sz#
Berne	sz#
[Berne]	sz#
Berwick	enk
Bethel, AK	aku
[Bethel, Alaska]	aku
Bethesda, Maryland	mdu
Bethesda, Maryland, USA	mdu
Bethesda, MD	mdu
Bethesda, MD.	mdu
Bethlehem	xx#
Bethlehem, PA	pau
[Bethseda, MD]	mdu
Beunos Aires	ag#
Beverley	enk
Beverley, England	enk
Bexhill-on-Sea	enk
Biarritz, France	fr#
Bicester	enk
Bichik	xx#
Bielefeld	gw#
Bielefeld and Leipzig	gw#
(Bielefeld and Leipzig)	gw#
Bielefeld und Leipzig	gw#
Bielefeld, Germany	gw#
Bielfeld and Leipzig	gw#
Bielfeld und Leipzig	gw#
[Big Delta, AK]	aku
[Biggleswade]	enk
Bilthoven, Netherlands	ne#
Bingham, Nott.	enk
Binghamton, NY	nyu
Birkenhead	enk
Birmingham	enk
Birmingham, AL	alu
[Birmingham, AL]	alu
Birmingham, UK	enk
[Birmingham]	enk
Bishop's Castle	enk
Bja^usta, Sweden	sw#
[Bjerkvik]	no#
Bjo^urk & Bo^urjesson	sw#
Bjo^urneborg, Sweden	sw#
Blacksburg, VA	vau
Blagoveshchensk	ru#
Blaine, WA	wau
Blenheim, NZ	nz#
Blieskastel, Germany	gw#
Bloemendaal, Netherlands	ne#
Bloemfontein, SA	sa#
Bloemfontein, South Africa	sa#
Bloemfonteine, South Africa	sa#
Bloomfield Hills, MI	miu
Bloomington	ilu
Bloomington, IL	ilu
Bloomington, IN	inu
Bloomington, IN,	inu
Bloomington, Indiana	inu
Bloomington, MN	mnu
Bloomington, US	xxu
Blue Ridge Summit, PA	pau
Bluntisham	enk
Bluntisham, Cambs.	enk
Bluntisham, England	enk
Boca Raton, FL	flu
Boca Raton, FL, USA	flu
Boca Raton, Florida	flu
Bochum	gw#
Bodo^z	no#
Bodo^z, Norway	no#
Boise, ID	idu
Bollstabruk, Sweden	sw#
Bologna	it#
Bologna - Italy	it#
Bologna, Italy	it#
(Bologna)	it#
Bombay	ii#
Bombay, India	ii#
Bonn	gw#
(Bonn)	gw#
[Bonn]	gw#
Boone, NC	ncu
Bora^os, Sweden	sw#
[Bora^os], Sweden	sw#
Boras	sw#
Bordeaux	fr#
Bordeaux le Bouscat	fr#
(Bordeaux)	fr#
Borga^o	fi#
Bosham	enk
Boston	xx#
Boston and New York	mau
Boston and Toronto	mau
Boston Spa	enk
Boston Spa, Wetherby	enk
Boston, etc	xx#
Boston, etc.	xx#
Boston, MA	mau
Boston, MA, USA	mau
[Boston, MA]	mau
Boston, Mass.,	mau
Boston, Mass., & Toronto	mau
Boston, Massachusetts	mau
Boston, US	mau
Boston, USA	mau
(Boston)	xx#
[Boston]	xx#
Boston]	xx#
Bothell, WA	wau
Boulder	cou
Boulder, CO	cou
(Boulder, CO)	cou
Boulder, Col.	cou
Boulder, Colarado	cou
Boulder, Colorado	cou
Boulder, USA	cou
Boulogne	fr#
Boulogne-Billancourt	fr#
Boulogne, France	fr#
Bourges	fr#
Bourgogne, France	fr#
Bourn	enk
Bourne End, Bucks.	enk
Bournemouth	enk
Bournemouth, England	enk
[Bournemouth]	enk
Bowie, MD	mdu
Bowling Green, OH	ohu
Box 2240, 105 Distributor St., Inuvik, NT, Canada X0E 0T0	ntc
Bozeman, MT	mtu
Bozen/Bolzano	it#
Bracknell	enk
Bracknell, Berkshire	enk
(Bracknell, Berkshire)	enk
[Bracknell, Berkshire]	enk
Bracknell, UK	enk
[Bracknell, UK]	enk
Bradford-on-Avon	enk
(Bradford-on-Avon)	enk
Braidwood, NSW	xna
Bramber, W. Sussex	enk
Brasi^alia	bl#
[Brasil]	bl#
Brasilia	bl#
Bratislava	xo#
(Bratislava)	xo#
Brattleboro, VT	vtu
Brattleboro, Vt.	vtu
Braunschweig	gw#
Braunschweig, Berlin	gw#
Braunschweig, Berlin, Hamburg	gw#
Braunschweig, Germany	gw#
(Braunschweig)	gw#
Brauschweig	gw#
[Brazil]	bl#
[Brazilia]	bl#
Breda	ne#
Bregenz	au#
Bremen	gw#
Bremen-Horn (Hannover)	gw#
Bremen, Germany	gw#
(Bremen)	gw#
Bremerhaven	gw#
Bremerhaven, GDR	gw#
Bremerhaven, Germany	gw#
[Bremerhaven, Germany]	gw#
(Bremerhaven)	gw#
[Bremerhaven]	gw#
Bremerhavn	gw#
Brentford, England	enk
(Brentford, England)	enk
(Brentford)	enk
[Brentor]	enk
Brescia	it#
Breslau	pl#
(Breslau)	pl#
Brest	fr#
Brest, France	fr#
Breton, Nova Scotia	nsc
Bridgend	enk
Bridgeport, CT	ctu
Bridgnorth, England	enk
Bridlington	enk
Brig, Switzerland	sz#
Brighton	enk
Brighton, Ont	onc
Brighton, UK	enk
Brisbane	qea
Brisbane, Australia	qea
Brisbane, Qld	qea
[Brisbane, Qld]	qea
(Brisbane)	qea
Bristol	enk
Bristol, England	enk
Bristol, PA	pau
Bristol, RI	riu
[Bristol]	enk
British Antarctic Meteorological Service	xxk
Brittany	fr#
Brixham	enk
Brno	xr#
Brno, Czech Republic	xr#
(Brno)	xr#
Bro^znno^zysund	no#
[Broadstone]	enk
(Broken Hill)	xna
Bromma, Sweden	sw#
Brookfield, CT	ctu
Brookline, MA.	mau
Brooklyn, New York	nyu
Brooklyn, NY	nyu
Brookvale, NSW	xna
Broomall, PA	pau
Brunn	gw#
(Brunswick)	gw#
Brussel	be#
Brussells	be#
Brussels	be#
[Brussels	be#
Brussels and Cheltenham	be#
Brussels, Belgian	be#
Brussels, Belgium	be#
[Brussels, Belgium]	be#
[Brussels?]	be#
(Brussels)	be#
[Brussels]	be#
Bruton, Somerset	enk
Bruxelles	be#
(Bruxelles)	be#
[Bruxelles]	be#
(Bruxells)	be#
Bryan-College Station	txu
Bryan, Texas	txu
Bu^uhl-Baden	gw#
Bucarest	rm#
Bucharest	rm#
Buckingham	enk
Buckley Field, CO	cou
Budapest	hu#
Budapest, Hungary	hu#
(Budapest)	hu#
[Budapest]	hu#
Budissime	gw#
Budleigh Salterton	enk
Buenos Aires	ag#
Buenos Aires and Santiago	ag#
Buenos Aires and Ushuaia	ag#
Buenos Aires,	ag#
Buenos Aires, Argentina	ag#
Buenos Aires?	ag#
(Buenos Aires)	ag#
[Buenos Aires]	ag#
Buffalo	nyu
Buffalo, NY	nyu
Builth Wells	wlk
Builth Wells, Wales	wlk
(Bukarest)	rm#
Bulgaria	bu#
Bulli	xna
Bungay	enk
Burgh Castle	enk
Burlington, Canada	onc
Burlington, NC	ncu
Burlington, Ontario	onc
Burlington, VT	vtu
Burlington,VT	vtu
Burnaby, B.C.	bcc
Burnaby, B.C., Canada	bcc
Burnaby, BC	bcc
Burnaby, BC, Canada	bcc
Burnstown, Ont.	onc
Bury St Edmunds	enk
Busan, Korea	ko#
C^veske^a Bude^vjovice	xr#
CA	cau
Caen	fr#
Caen, France	fr#
(Caen)	fr#
Cairns	qea
Calagary	abc
Calcutta	ii#
Caldwell	nj#
Caldwell (Idaho)	idu
Caldwell, ID	idu
Calgary	abc
Calgary,	abc
Calgary, AB	abc
Calgary, AB: Arctic Institute of North America	abc
Calgary, Alba	abc
Calgary, Alberta	abc
[Calgary, Alberta]	abc
Calgary, Alta	abc
Calgary, Alta, Canada	abc
Calgary, Alta.	abc
[Calgary, Alta.]	abc
Calgary, Canada	abc
[Calgary]	abc
California	cau
Callaghan, NSW	xna
Caluire	fr#
Calwell	aca
Camaurac	fr#
Camberley	enk
Camberwell South, Australia	vra
Camberwell, Vic.	vra
Cambridge	enk
Cambridge Bay, NT	nuc
Cambridge MA	mau
Cambridge, England	enk
Cambridge, MA	mau
Cambridge, MA,	mau
Cambridge, MA, USA	mau
[Cambridge, MA]	mau
Cambridge, Mass.	mau
(Cambridge, Mass.)	mau
Cambridge, Massachusetts	mau
(Cambridge, Massachusetts)	mau
Cambridge, MD	mdu
Cambridge, UK	enk
[Cambridge?]	enk
(Cambridge)	enk
[Cambridge]	enk
Cambrudge	enk
Camden East, Ontario	onc
Camden, ME	meu
Camerino, Italy	it#
Cameron Island, N.W.T.	ntc
Camurac	fr#
Canaan, NH	nhu
Canada	xxc
[Canada]	xxc
(Canadian Meteorological and Oceanographic Society)	xxc
Canberra	aca
Canberra City	aca
Canberra, ACT	aca
[Canberra, ACT]	aca
Canberra, Australia	aca
(Canberra)	aca
[Canberra]	aca
Canda	xxc
Canelones, Uruguay	uy#
Canmore, AB	abc
Canmore, AB, Canada	abc
Canmore, Alta	abc
Canmore, Alta.	abc
Canoga Park, CA	cau
Canterbury	enk
Canterbury, NSW	xna
Canterbury, NZ	nz#
Canton, MA	mau
Cap-de-la-Madelaine, Que^a	quc
Cape Dorset, NWT	ntc
Cape Town	sa#
Cape Town, RSA	sa#
Cape Town, South Africa	sa#
[Cape Town]	sa#
Carbondale and Edwardsville, IL	ilu
Cardiff	wlk
Cardigan	wlk
Carlisle, WA	wau
[Carlisle]	enk
Carlsbad, CA	cau
Carlskrona	sw#
Carlton	vra
Carlton, Vic.	vra
Carlton, Victoria	vra
Carnarvon, Western Australia	wea
Carson City, Nevada	nvu
Carson City, NV	nvu
[Cary, NC]	ncu
Casale, Monf.	it#
Cavallermaggiore	it#
Cavallermaggiore, Italy	it#
Cawdor, Scotland	stk
Caxias do Sul, Brazil	bl#
Caxton Hill, Herts	enk
Caxton, ID	idu
[Cedar Falls, IA]	iau
Centennial, CO	cou
Centerton, NJ	nju
Central Lydbrook	enk
Centreville, MD	mdu
Cerveny^a Kostelec	xr#
CH-Seewis/GR, Switzerland	sz#
Cha^htelaine, Switzerland	sz#
Chalfont St Peter	enk
Chalfont St Peter, Bucks.	enk
Chalfont St. Peter	enk
Chalfont St. Peter, UK	enk
Chalfort St Giles	enk
Chambe^ary	fr#
Chamonix Mont Blanc	fr#
Champaign, IL	ilu
Champaign, IL.	ilu
Champigny-sur-Marne, France	fr#
Chaneliak, AK	aku
Chanhassen, MN	mnu
Chania, Crete	gr#
Chapel Hill	ncu
Chapel Hill, NC	ncu
[Chapel Hill, NC]	ncu
Chapel Hill, North Carolina	ncu
Chapell Hill, NC	ncu
[Charenton-le-Pont]	fr#
Charlebourg, QC	quc
Charleroi, Belgium	be#
Charlesbourg, Que	quc
Charleston, SC	scu
Charlotte, NC	ncu
Charlottelund, Denmark	dk#
Charlottenlund	dk#
Charlottenlund Slot, Denmark	dk#
Charlottenlund, Denmark	dk#
[Charlottenlund]	dk#
Charlottesville, VA	vau
Charlottetown, Nwf	nfc
Charlottetown, PEI	pic
Charlton, Kent	enk
Chatham	enk
Chelmsford	enk
(Chelmsford)	enk
Chelsea, MA	mau
Cheltenham	enk
Cheltenham, UK	enk
Chelyabinsk	ru#
(Cheney)	aku
Cherskiy	ru#
Chesterfield	enk
[Chesterfield]	enk
Chestertown	mdu
Chestnut Hill, MA	mau
Chevy Chase, MD	mdu
Cheyenne, WY	wyu
Chiavari, Italy	it#
Chibougamau, Que.	quc
Chicago	ilu
Chicago : a lecture delivered at the University of Chicago, December 3, 1957	ilu
Chicago and London	ilu
Chicago and New York	ilu
(Chicago Natural History Museum)	ilu
Chicago, IL	ilu
[Chicago, IL]	ilu
Chicago, Illinois	ilu
(Chicago)	ilu
[Chicago]	ilu
Chichester	enk
Chichester, England	enk
Chichester, etc.	enk
Chichester, UK	enk
Chico, CA	cau
Chicoutimi	quc
Chile	cl#
Chilton, Oxfordshire	enk
China Lake, California	cau
(China)	cc#
Chippenham	enk
Chippenham (Great Britain)	enk
Chippenham, England	enk
Chipping Norton, NSW	xna
Chiroulet, France	fr#
Chiswick	enk
Chita	ru#
Cholet, France	fr#
Christchurch	nz#
Christchurch (new Zealand)	nz#
Christchurch NZ	nz#
[Christchurch NZ]	nz#
Christchurch, Dorset	enk
Christchurch, etc.	xx#
Christchurch, N.Z	nz#
Christchurch, N.Z.	nz#
Christchurch, New Zealand	nz#
(Christchurch, New Zealand)	nz#
Christchurch, Newzealand	nz#
Christchurch, NZ	nz#
[Christchurch, NZ]	nz#
Christchurch, Wellington, etc.	nz#
(Christchurch)	nz#
[Christchurch]	nz#
Christiana	no#
Christiania	no#
Christiania [Oslo]	no#
Christiania and Copenhagen	no#
(Christiania)	no#
Christiansfeld	dk#
[Chukotka]	ru#
Churchill	mbc
Churchill, Man.	mbc
Churchill, Manitoba	mbc
[Churchill, Manitoba]	mbc
Cincinnati	ohu
Cincinnati, OH	ohu
(Cincinnatti)	ohu
[Cinda Park]	sa#
Cirencester	enk
Civitanova Marche	it#
Civitanova Marche (Macerata)	it#
Civitanova Marche, Italy	it#
Clapham (via Lancaster), Yorkshire	enk
Clapham, N. Yorks	enk
Claremont, South Africa	sa#
Clarence St. NSW	xna
Clarence St., NSW	xna
Clark Mills, NY	nyu
[Clayton South, VIC]	vra
[Clayton, Vic.]	vra
Clermont-Ferrand, France	fr#
Cleveland	ohu
Cleveland and New York	ohu
Cleveland, OH	ohu
Clifton, Bristol	enk
Clinton, NJ	nju
(Cloverdale, BC)	bcc
Clyde River NWT	ntc
Co^ardoba	ag#
Co^ardoba, Argentina	ag#
(Co^ardoba)	ag#
Co. Kildare	ie#
Cobalt, Ont.	onc
Coblenz	gw#
Coburg	gw#
Codicote	enk
Cointe-Ougre^ae	be#
Colchester	enk
[Colchester]	enk
Cold Spring Harbor	nyu
Cold Spring Harbor, NY	nyu
Cold Spring Harbour	nyu
Colingwood, VIC	vra
College	aku
College Station	txu
College Station, Texas	txu
College Station, TX	txu
[College Station, TX]	txu
College Station,Tx	txi
College, AK	aku
[College, AK]	aku
College, Alaska	aku
[College]	aku
[Collingwood, Ont.]	onc
Collingwood, VIC	vra
Colmar	fr#
Colmar, France	fr#
Cologne, Germany	gw#
Coloma, MI	miu
Colombia, MO	mou
Colorado	cou
Colorado Springs	cou
Colorado Springs, CO	cou
(Colorado Springs, CO)	cou
Colorado, CO	cou
Columbia	xx#
Columbia, MD	mdu
Columbia, SC	scu
Columbus	ohu
Columbus, OH	ohu
Columbus, OH and Boulder, CO	ohu
Columbus, OH,	ohu
[Columbus, OH]	ohu
Columbus, Ohio	ohu
[Columbus], Ohio	ohu
Colvin Lake. NWT	ntc
Colwall	enk
Commack, NY	nyu
Como, Luglio	it#
Comox, British Columbia	bcc
Concepcio^an, Chile	cl#
(Concepcio^an)	cl#
Concepcion	cl#
Concepcion, Chile	cl#
Concord, MA	mau
Concord, NH	nhu
(Concord, NH)	nhu
Concord, ON	onu
Connecticut	ctu
Conneticut	ctu
Cooksville, MD	mdu
Copenhagen	dk#
Copenhagen and Kristiania	dk#
Copenhagen and Oslo	dk#
Copenhagen and Reykjavi^ak	dk#
Copenhagen K	dk#
Copenhagen og Odense	dk#
Copenhagen, Denmark	dk#
Copenhagen, etc.	dk#
[Copenhagen?]	dk#
(Copenhagen)	dk#
[Copenhagen]	dk#
Copenhague	dk#
Cophenhagen	dk#
Copp Clark Pitman Ltd	onc
Copper Center, AK	aku
Coquimbo, Chile	cl#
Coral Gables, FLA	flu
Cordoba	ag#
Cordoba, Argentina	ag#
Cordova and Anchorage, AK	aku
Cordova, AK	aku
Cordova, Alaska	aku
Cork	ie#
[Cork]	ie#
Cornell	nyu
Cornwall-on-Hudson, N.Y.	nyu
[Cornwall]	enk
Cornwallis, Oregon	oru
Coronulla, Sydney, NSW	xna
Corvallis, OR	oru
Corvallis, USA	oru
Costa Mesa, CA	cau
[Cottenham]	enk
Coventry, England	enk
Coyoaca^an	mx#
Cracovie	pl#
Cracow, Poland	pl#
Craigiebuckler, Aberdeen	stk
Cranbury, NJ	nju
Cranfield	enk
[Cranwell]	enk
Crawley, Sussex	enk
(Cremlingen-Destedt)	gw#
Cremorne, NSW	xna
Crestwood, New York	nyu
Crestwood, NY	nyu
Crickhowell, Powys	wlk
Cromer	enk
Crookham	enk
Cross Village, MI	miu
Croton-on-Hudson, NY	nyu
Crow's Nest, NSW	xna
Crows Nest, NSW	xna
Croydon	enk
Croydon, Victoria	vra
(Croydon)	enk
[Croydon]	enk
CRTA	xx#
CT	ctu
Cumbria	enk
Cumbria, U.K.	enk
Cupertino, CA	cau
Cutchogue, NY	nyu
D'okuuskay	ru#
D'ukuuskay	ru#
D'yokuuskay	ru#
Dallas, Texas	txu
Dallas, TX	txu
[Dallas, TX]	txu
Dana Point, CA	cau
Danbury, CT	ctu
Dangar Island	xna
Danmark	dk#
Danmarks	dk#
Danville, IL	ilu
(Danzig)	po#
Darien CT	ctu
Darien, CT	ctu
Darmstadt	gw#
Darmstadt-Eberstadt	gw#
Darmstedt-Eberstadt	gw#
Darrien, CT	ctu
Dartford	enk
Dartmouth	enk
Dartmouth College	enk
(Dartmouth College Library)	enk
[Dartmouth, Devon]	enk
(Dartmouth, N.H.)	nhu
Dartmouth, N.S.	nsc
Dartmouth, NH	nhu
Dartmouth, Nova Scotia	nsc
[Dartmouth, Nova Scotia]	nsc
Dartmouth, NS	nsc
[Dartmouth, NS]	nsc
Dartmouth, USA	nsc
Darwin, Australia	xoa
DAT	fi#
Davis	cau
Davis, CA	cau
Davos	sz#
Davos, Switzerland	sz#
[Davos]	sz#
Dawson City	ykc
Dawson City, YK	ykc
Dayton, OH	ohi
De Bilt, Netherlands	ne#
De Bilt, NL	ne#
De^aline, NWT	ntc
DeKalb, IL	ilu
Del Mar, CA.	cau
Delaware	deu
Delft	ne#
Delft, Holland	ne#
[Delft]	ne#
Delhi	ii#
[Delhi]	ii#
Delta, British Columbia	bcc
Den Haag	ne#
(Den Haag)	ne#
Denali, AK	aku
Denmark	dk#
Denmark Aps	dk#
[Denmark]	dk#
Denton, Harleston, Norfolk	enk
Denver	cou
Denver, CO	cou
Denver, CO.	cou
Denver, Colorado	cou
[Denville, NJ]	nju
Derby	enk
Des Moines, WA	wau
Dessau	gw#
Det gro^znlandske Forlag	dk#
Detmold	gw#
Detroit and London	miu
Detroit, MI	miu
[Detroit?]	miu
Deventer	ne#
[Devon]	enk
Dijon	fr#
Dillingham, AK	aku
Dinan	fr#
[Dinard]	fr#
Dingwall	stk
Ditchley Park, England	enk
Dobbs Ferry	nyu
Dobbs Ferry, NY	nyu
Don Mills	onc
Don Mills, Ont	onc
Don Mills, Ont.	onc
Don Mills, Ontario	onc
Doncaster	enk
Doncaster East, Vic, Australia	vra
Donetsk	un#
Dorchester	enk
Dordrecht	ne#
Dordrecht, Holland	ne#
Dordrecht, Netherlands	ne#
[Dordrecht, Netherlands]	ne#
Dordrecht, NL	ne#
Dordrecht, The Netherlands	ne#
Dorking	enk
Dorset, England	enk
Dortmund	gw#
Dortmund, Germany	gw#
Douaghloyne, Eire	ie#
Doughcloyne, Eire	ie#
Douglas (Isle of Man)	uik
Douglas, AK	aku
Dover	enk
Dowlais	onc
Downsview, Ont.	onc
Downsview, Ontario	onc
[Downsview, Ontario]	onc
Drag	no#
Drag, Norway	no#
Dresden	gw#
(Dresden)	gw#
Drexel Hill (Pa.)	pau
Driebergseweg	ne#
Drofa	ru#
Drottningholm, Sweden	sw#
Drummoyne, NSW	xna
Du^usseldorf	gw#
Du^usseldorf-Oberkassel	gw#
Dublin	ie#
(Dublin-London)	ie#
[Dublin]	ie#
Dubuque, IA	iau
Dudinka	ru#
Dugway, UT	utu
Dulles, VA	vau
Duluth, MN	mnu
Dulwich	enk
Dumphries, Scotland	stk
Dunbeath	enk
Duncan, BC	bcc
Dundee	stk
[Dundee]	stk
Dundein, NZ	nz#
Dunean, BC	bcc
Dunedin	nz#
Dunedin, New Zealand	nz#
Dunedin, NZ	nz#
[Dunedin]	nz#
Dunton Bassett	enk
Durban	sa#
Durban, RSA	sa#
Durham	enk
Durham, England	enk
Durham, NC	ncu
Durham, NH	nhu
[Durham, NH]	nhu
[Durham]	enk
Dusseldorf	gw#
[Dusseldorf]	gw#
Duxbury, MA	mau
Dziekano^aw Les^any	pl#
Eaglewood Cliffs, NJ	nju
East Brunswick, New Jersey	nju
East Grinstead	enk
East Grinstead, England	enk
East Lansing	miu
East Lansing, MI	miu
East Lawrencetown, NS	nsc
East Linton, Scotland	stk
East Malling, Kent	enk
East Melbourne, Victoria (Australia)	vra
East Molesey	enk
East Retford	enk
East Roseville, Australia	xna
Eastbourne	enk
[Eastbourne]	enk
[Ebenda]	xx#
Eccles	enk
Ecully	fr#
[Edgecombe, ME]	meu
Edgware	enk
Edina, MN	mnu
(Edinbugh)	stk
(Edinburg)	stk
Edinburgh	stk
Edinburgh and London	stk
Edinburgh, London	stk
Edinburgh, Scotland	stk
[Edinburgh, Scotland]	stk
Edinburgh, Tristan da Cunha	xj#
(Edinburgh)	stk
[Edinburgh]	stk
Edingurgh	stk
Edison, NJ	nju
Edizioni della Laguna	it#
Edmonds, WA	wau
Edmonton	abc
Edmonton, AB	abc
[Edmonton, AB]	abc
Edmonton, Alb.	abc
Edmonton, Alberta	abc
(Edmonton, Alberta)	abc
[Edmonton, Alberta]	abc
Edmonton, Alta	abc
Edmonton, Alta.	abc
[Edmonton, Alta.	abc
[Edmonton, Alta.]	abc
[Edmonton, Alta]	abc
Edmonton, Canada	abc
Edmonton. Alberta	abc
[Edmonton]	abc
Edsbruk, Sweden	sw#
Egdean, West Sussex	enk
Eglin Field, FL	flu
Eglin Field, Fla.	flu
Eindhoven, The Netherlands	ne#
Eisenach	gw#
Ekaterinburg	ru#
Ekenas	fi#
El Paso, TX	txu
El Segundo, CA	cau
Elberfeld	gw#
Elista	ru#
Elk Grove Village, IL	ilu
Elkhart Lake, WI	wiu
(Elora, Ontario)	onc
Elphinstone, Victoria, Australia	vra
Elsevier	xx#
Eltham	enk
Ely	enk
Ely, MN	mnu
Emeryville, CA	cau
Ena^onger, Sweden	sw#
Enfield	enk
England	enk
Englewood Cliff, NJ	nju
Englewood Cliffs, N.H.	nhu
Englewood Cliffs, NJ	nju
Englewood, CO	cou
Enschede, The Netherlands	ne#
Epalinges, Switzerland	sz#
Epsom, Surrey	enk
Erbach	gw#
Erbach (Odenwald)	gw#
Erin, Ontario	onc
Erlensee, Germany	gw#
Ermelo, Netherlands	ne#
Esbjerg, Denmark	dk#
[Esbo, Finland]	fi#
Eskimo Point	nuc
Eskimo Point, Canada	nuc
Eskimo Point, NWT	nuc
(Eskimo Point, NWT)	nuc
Espa, Norway	no#
Espanol	sp#
Espergaerde, Denmark	dk#
Espoo	fi#
Espoo, Finland	fi#
Esquimalt, B.C.	bcc
Essen	gw#
Essertines-sur-Rolle	sz#
[Estella, Navarra]	sp#
Ester, AK	aku
Estonia	er#
Eugene, OR	oru
Eugenia, ON	onc
Eva Pero^an (La Plata)	ag#
Evanston	ilu
Evanston, IL	ilu
Evanston, USA	ilu
Evergreen, CO	cou
[Evreux]	fr#
Ewell, Surrey	enk
Exeter	enk
[Exeter]	enk
Exford, Devon	enk
Exmouth	enk
Expe^adition Glaciologique Internationale au Groenland	xx#
Exton, PA	pau
Fair Lawn NJ, USA	nju
Fairbank, AK	aku
Fairbanks	aku
Fairbanks AK	aku
Fairbanks, A	aku
Fairbanks, AK	aku
Fairbanks, AK, USA	aku
Fairbanks, AK.	aku
(Fairbanks, AK)	aku
[Fairbanks, AK]	aku
Fairbanks, AL	aku
Fairbanks, Alaska	aku
Fairbanks, Alaska, USA	aku
[Fairbanks, Alaska]	aku
Fairbanks, USA	aku
[Fairbanks]	aku
Fairfield	cau
(Fairfield, CA)	cau
Fairfield, WA	wau
Fairhaven, MA	mau
Fairhaven, Mass	mau
Fairhaven, Massachusetts	mau
Falkland Islands	fk#
[Falkland Islands]	fk#
Falls Church, VA	vau
Falls Church, Virginia	vau
Falun, Sweden	sw#
Far Hills, USA	nju
Farborough, Hants	enk
Faringdon	enk
[Farmington, NM]	nmu
Farnborough	enk
Farnborough, Hampshire	enk
Farnborough, Hampshire, Royal Aircraft Establishment, National Remote Sensing Centre, Space and New Concepts Department	enk
Farnborough, UK	enk
Farnham	enk
Faroe Islands	fa#
Fayetteville, Aka	aku
Fayetteville, AR	aru
Fayetteville, NY	nyu
Felling-on-Tyne	enk
[Felsted]	enk
Feltham, England	enk
Fermo	it#
Fermo, Italy	it#
(Fermo)	it#
[Fermo]	it#
Ferndale, MI	miu
Ferntree Gully, Victoria	vra
Fife, Scotland	stk
Finchley, London	enk
Finland	fi#
[Finland]	fi#
Finningley, Yorkshire	enk
Firenze	it#
(Firenze)	it#
[Firenze]	it#
Fiscataway, New Jersey	nju
Fisher, ACT	aca
[Fjaerland]	no#
FL	flu
[Flagstaff, Arizona]	azu
Flagstaff, AZ	azu
Flata^osen	no#
(Flata^osen), Norway	no#
Fleetwood	enk
Flensburg	gw#
Flinders	xra
Flinders Park, Australia	xra
Florence, Italy	it#
(Florence)	it#
Florida	flu
Florida, USA	flu
Folkestone	enk
Folkestone, England	enk
Footscray, Vic.	vra
For Collins, Colorado	cou
Fordingbridge, England	enk
Forestville, CA	cau
Forssa, Finland	fi#
Fort Belvoir, VA	vau
Fort Colins, CO	cou
Fort Collins, CO	cou
[Fort Collins, CO]	cou
Fort Collins, Colorado	cou
[Fort Collins, Colorado]	cou
Fort Eustis	vau
[Fort Eustis]	vau
[Fort Leavenworth, AR.]	aru
Fort Leavenworth, Kansas	ksu
Fort Leavenworth, KS	ksu
Fort Monmouth NJ	nju
Fort Monmouth, NJ	nju
Fort Nelson, B.C.	bcc
Fort Nelson, BC	bcc
Fort Pierce, FL	flu
Fort Providence, NT	nuc
Fort Simpson	nuc
Fort Smith, NT	nuc
Fort Smith, NWT	ntc
(Fort Smith, NWT)	ntc
Fort Wainwright	aku
Fort Wainwright, AK	aku
(Fort Wainwright, AK)	aku
(Fort Wainwright, Alaska)	aku
Fort William	stk
Fort Worth	txu
Fowlerville, MI	miu
France	fr#
Francheville	fr#
Francheville, France	fr#
Francof	xx#
Francoforti	xx#
Francofurti apud Ascany de [Rimaine?]	xx#
Frankfort, KY	kyu
Frankfurt	gw#
(Frankfurt a.M.)	gw#
Frankfurt am Main	gw#
Frankfurt am Main, Germany	gw#
(Frankfurt am Main)	gw#
Frankfurt-am-Main	gw#
Frankfurt, Germany	gw#
(Frankfurt)	gw#
Frascati, Italy	it#
Frauenfeld	sz#
Fredericia	dk#
Fredericton, NB	nkc
Fredericton, NB, Canada	nkc
Fredericton, New Brunswick	nkc
Frederiksberg, Denmark	dk#
[Frederiksberg]	dk#
Fredoricton, N.B	nkc
Fredriksberg, Denmark	dk#
Freemantle, Australia	wea
Freemantle, WA	wea
Freeport, ME	meu
Freeport, NY	nyu
(Freiberg/Mu^unchen)	gw#
Freiburg	gw#
Freiburg im Breisgau	gw#
Freiburg, Germany	gw#
(Freiburg, Switzerland)	sz#
(Freiburg)	gw#
Freshwater	enk
Freshwater, IoW	enk
Frobisher Bay	ntc
Frobisher Bay, NWT	ntc
Frunze	ta#
Fu^urstenberg	gw#
Fullerton, CA	cau
Funadcio^an Marambio	ag#
Funchal	po#
Fundcio^an Marambio	ag#
Furstenberg	gw#
Furstenberg/Havel	gw#
Fyshwick, ACT	aca
Ga^ullstad, Sweden	sw#
Ga^uvle, Sweden	sw#
Gaia^as, Spain	sp#
Gainesville	flu
Gainesville, FL	flu
Gaithersburg, MD	mdu
Galicia	sp#
Galway	ie#
Gamla Varberg	sw#
Ganges, BC	bcc
Ganiteau, Que	quc
[Gansu Province]	cc#
Garden City, N.Y.	nyu
Garden City, NY	nyu
Garmisch-Partenkirchen	gw#
Garmisch-Partenkirchen, Denmark	gw#
Garston	enk
Gartocharn	stk
Gatineau	quc
Gatineau, Que.	quc
[Gatineau, Que.]	quc
Gdan^ask, Poland	pl#
Gdansk	pl#
Gdansk, Poland	pl#
Gdynia	pl#
Gdynia, Poland	pl#
(Gdynia, Poland)	pl#
Ge^ane^gve	sz#
Ge^anova	it#
Geel, Belgium	be#
Geelong, Australia	vra
Geelong, VIC	vra
Geesthacht	gw#
Geesthacht, Germany	gw#
Gembloux	be#
Gene^ave	sz#
Gene^gve	sz#
(Gene^gve)	sz#
[Gene^gve]	sz#
Geneva	sz#
Geneva, Switzerland	sz#
Geneva?	sz#
(Geneva)	sz#
[Geneva]	sz#
Genf, Switzerland	sz#
Genoa	it#
Genoa, Italy	it#
Genova	it#
Genova, Italy	it#
(Genova)	it#
Gent, Belgium	be#
Gentbrugge	be#
Gentbrugge, Belgium	be#
[Gentofte]	dk#
Geological Surveys of Norway and Finland	xx#
Georgetown	cau
Georgetown, Cal.	cau
Georgeville, Que	quc
Germany	gw#
[Germany]	gw#
Germering	gw#
Ghent	be#
Gibsons, BC	bcc
Gie^gres, France	fr#
Giessen	gw#
Giessen, Germany	gw#
Gif sur Yvette	fr#
Gilles Troispoux, 2 rue Turbil, 69003 Lyon, France	fr#
Girard, Ka	ksu
Girard, KS	ksu
Girton, Cambridge	enk
Gjo^zra	no#
Gland	sz#
Gland (Switzerland)	sz#
Gland and Cambridge	sz#
Gland, Switzerland	sz#
Gland, Switzerland?	sz#
[Gland, Switzerland]	sz#
Glasgow	stk
Glasgow and London	stk
Glasgow, KY	kyu
[Glasgow]	stk
Gleerup	xx#
Glendale	cau
Glendale, CA	cau
[Glendale, CA]	cau
Glenorchy, Tasmania	tma
Glenwood, NM	nmu
Gloucester	enk
Gloucester, MA	mau
Gloucester, Ont	onc
Gloucester, UK	enk
[Gloucester]	enk
Glu^uckstadt-Hamburg	gw#
Glu^uckstadt, Hamburg and New York	gw#
Gnadau	gw#
Go^uteborg	sw#
Go^uteborg, Sweden	sw#
(Go^utha)	gw#
Go^utingen	gw#
Go^uttingen	gw#
Go^uttingen, Germany	gw#
[Go^uttingen, Germany]	gw#
Go^zteborg	sw#
Goa	ii#
Goa, India	ii#
[Goa]	ii#
Godalming	enk
[Godalming, England]	enk
Godalming, Surrey	enk
(Godalming)	enk
[Godalming]	enk
Godhavn, Greenland	gl#
[Godhavn, Greenland]	gl#
Godtha^ab	gl#
Godtha^ob	gl#
Godtha^ob, Greenland	gl#
[Godtha^ob, Greenland]	gl#
(Godtha^ob)	gl#
[Godtha^ob]	gl#
Godthaab	gl#
Gold Spring Harbor, NY	nyu
Golden, CO	cou
Golden, CO USA	cou
Golden, CO, USA	cou
Golden, Colorado	cou
Goleta, CA	cau
Gore, New Zealand	nz#
Gorham, NH	nhu
Goring, Oxon	enk
[Gorizia]	it#
Gorno-Altaisk	ru#
Gorno-Altaysk	ru#
Gosudarstvennoye izdatel'stvo geograficheskoy literatury	ru#
Goteborg	sw#
Gotha	gw#
Gotha, Germany	gw#
(Gotha)	gw#
Gothenburg	sw#
Gothenburg, Sweden	sw#
Government House, Stanley	fk#
Gra^unna	sw#
Grafenhau, Germany	gw#
Grahamstown	sa#
Grand Rapids, MI	miu
Grantown-on-Spey	stk
Grantown-on-Spey, Scotland	stk
Graveland	xx#
Gravesend, England	enk
Graz	au#
Graz and Wien	au#
Great Bookham, Surrey	enk
Great Britain	enk
(Great Britain)	enk
Greece	gr#
Green Bay, WI	wiu
Greenbelt	mdu
Greenbelt MD	mdu
Greenbelt, Maryland	mdu
Greenbelt, MD	mdu
[Greenbelt, MD]	mdu
Greenford	enk
Greenland	gl#
[Greenland]	gl#
Greenwich	enk
Greenwich, CN	ctu
(Greenwich, CT)	ctu
Greenwich, England	enk
Greenwood Village, CO	cou
Greifswald	gw#
Grenoble	fr#
Grenoble, France	fr#
Grenoble, Paris	fr#
[Grenoble]	fr#
Grenville, SC	scu
Greve, Denmark	dk#
Greystones, Wicklow	ie#
Grimmen in Pommern	gw#
Grimsby	enk
Gro^znland	gl#
Gro^znlands Kommando	gl#
(Gro^znlandske Selskab)	gl#
Groningen	ne#
Groningen-den Haag	ne#
Groningen, Netherlands	ne#
[Groningen, Netherlands]	ne#
[Groningen?]	ne#
(Groningen)	ne#
Groton, Connecticut	ctu
Gu^utersloh	gw#
Guayaquil, Ecuador	ec#
Guelp, Ontario	onc
Guelph	onc
Guelph, Ont.	onc
Guelph, Ontario	onc
Guildford	enk
Guildford, CT	ctu
Guilford, CT	ctu
Guiseley	enk
Guovdageaidnu	no#
Guovdageaidnu, Norway	no#
Guovdageaidnu, Norway?	no#
Guovdageaidnu/Kautokeino, Norway	no#
Gustavus, AK	aku
Gydpro^zven (Greenland)	gl#
Gyldendal	fi#
Ha^umeenlinna	fi#
Ha^umeenlinna, Finland	fi#
[Ha^umeenlinna, Finland]	fi#
[Ha^umeenlinna], Finland	fi#
Ha^urno^usand, Sweden	sw#
Haarlem	ne#
Haarlem, Netherlands	ne#
Haarlem, The Netherlands	ne#
Haderslev	dk#
Haderslevime	dk#
Hafniae	dk#
(Hagerstown, Fairchild Engine and Airplane Corporation)	mdu
The Hague	ne#
Hague	ne#
The Hague, Netherlands	ne#
Hailsham, Santa Cruz de la Palma	enk
[Haines Junction, YT]	ytc
Hakodate	ja#
Hakodate, Japan	ja#
Halden	no#
(Hale)	enk
Halfmoon Bay, BC	bcc
Halifax	enk
Halifax, Nova Scotia	nsc
Halifax, NS	nsc
[Halifax]	enk
Halle	gw#
Halle (Saale)	gw#
(Halle, a/S)	gw#
Halle, Germany	gw#
(Halle)	gw#
Halle/Saale	gw#
Halver	gw#
Hamburg	gw#
Hamburg & Berlin	gw#
Hamburg and Berlin	gw#
Hamburg and Bremerhaven	gw#
Hamburg and Rostock	gw#
Hamburg, Germany	gw#
(Hamburg)	gw#
[Hamburg]	gw#
Hamden, CT	ctu
Hamden,CT	ctu
Hamilton	stk
Hamilton, AK	aku
Hamilton, MT	mtu
Hamilton, New Zealand	nz#
Hamilton, NZ	nz#
Hamilton, Ont.	onc
Hamilton, Ontario	onc
Hammerfest	no#
Hammersmith	enk
Hammondsworth	enk
Hampton, VA	vau
Hampton, Virginia	vau
Hanley Swan, Worcs.	enk
Hanna, Alberta	abc
Hannover	gw#
Hannover, Germany	gw#
(Hannover, NH)	nhu
Hanover	xx#
Hanover and London	gw#
Hanover, Germany	gw#
Hanover, MD	mdu
(Hanover, N.H.)	nhu
(Hanover, N.H)	nhu
Hanover, New Hampshire	nhu
Hanover, New Hampshire, USA	nhu
Hanover, NH	nhu
(Hanover, NH)	nhu
[Hanover, NH]	nhu
[Hanover]	xx#
Hanscom AFB, MA	mau
Hanscom Air Force Base, MA	mau
Hanscom Air Force Base, Massachusetts	mau
Hanscomb AFB, MA	mau
Haparanda	sw#
Haparanda, Sweden	sw#
Happy Valley - Goose Bay	nfc
Happy Valley - Goose Bay, Labrador	nfc
Happy Valley-Goose Bay	nfc
Happy Valley, Nfld	nfc
[Happy Valley]	nfc
Harleston	enk
Harlingen, Netherlands	ne#
Harlow	enk
Harlow, England	enk
Harlow, Essex	enk
Harmondsworth	enk
Harmondsworth, England	enk
Harmondsworth, Middlesex	enk
(Harmondsworth)	enk
Haroue^a, France	fr#
Harpenden	enk
Harrisburg	pau
Harrisburg, PA	pau
Harstad	no#
Harstad, Norway	no#
Hartford, CN	ctu
Hartford, Connecticut	ctu
Hartford, CT	ctu
Hartwell, Vic.	vra
Hartwell, Victoria	vra
Harvard	mtu
Harvard University Press	mtu
(Harvard University)	mtu
(Harwich)	enk
Harzburg	gw#
Hasselt	be#
[Hasselt]	be#
Hatfield	enk
(Hatfield)	enk
Hattiesburg, MS	msu
Haugesund, Norway	no#
Hauppauge, NY	nyu
(Havana)	cu#
Haverford, PA	pau
Haverfordwest	enk
Hawaii	hiu
[Hawaii]	hiu
Hawke's Bay, NZ	nz#
Hawthorn	vra
Hawthorn East, Vic.	vra
Hawthorn East, Victoria	vra
Hawthorn, Australia	vra
Hawthorn, Vic	vra
Hawthorn, Vic.	vra
Hawthorn, Victoria	vra
Hawthorn, Victoria (Australia)	vra
Hawthorne, VIC	vra
Hay River, Canada	ntc
Hay River, N.W.T.	ntc
Hay River, NWT	ntc
Heacham	enk
Heathfield	enk
Hedemora	sw#
Heemstede	ne#
Heide	gw#
Heidelberg	gw#
Heidelberg, Germany	gw#
(Heidelberg)	gw#
[Heidelberg]	gw#
Heiden, Switzerland	sz#
Heidenheim	gw#
[Heilongjiang]	cc#
Helena, MT	mtu
Hellerup (Denmark)	dk#
Hellerup, Denmark	dk#
Helsingborg	sw#
Helsingfors	fi#
Helsingfors, Finland	fi#
Helsingfors, Sweden	sw#
(Helsingfors)	fi#
Helsingissa^u	fi#
Helsingo^zr	dk#
Helsingo^zr, Denmark	dk#
Helsinki	fi#
Helsinki, Finland	fi#
(Helsinki)	fi#
[Helsinki]	fi#
Hemel Hemstead, England	enk
Hemingford Abbots	enk
Hemingford Abbotts	enk
Henley-on-Thames	enk
[Henley-on-Thames]	enk
Henningsvaer, Norway	no#
Heraklion, Greece	gr#
Hereford, England	enk
Herford	enk
Hermanus	sa#
Herndon, VA	vau
Herrnhut, Germany	gw#
[Herrnhut, Germany]	gw#
Herrsching	gw#
Hersham	enk
Hicksville, NY	nyu
High Wycombe	enk
High Wycombe, England	enk
Highlands Ranch, CO	cou
(Hildburghausen)	gw#
Hinckley	enk
Hindhead, Surrey	enk
Hinesville, GA	gau
Ho^ugana^us, Sweden	sw#
Ho^zjberg, Denmark	dk#
[Ho^zjberg]	dk#
Ho^zjbjerg	dk#
Ho^zjbjerg, Denmark	dk#
Ho^zlen, Norway	no#
Ho^zrsholm	dk#
Ho^zrsholm, Denmark	dk#
Ho^zvik, Norway	no#
Hobart	tma
(Hobart Town)	tma
Hobart, Australia	tma
Hobart, TA	tma
Hobart, TAS	tma
Hobart, Tas.	tma
[Hobart, Tas.]	tma
[Hobart, Tas]	tma
Hobart, Tasmania	tma
(Hobart, Tasmania)	tma
[Hobart, Tasmania]	tma
(Hobart)	tma
[Hobart]	tma
Hobert	tma
Hoboken	nju
Hoboken, New Jersey	nju
Hoboken, NJ	nju
[Hoboken, NJ]	nju
Hohen-scaftlarn	gw#
Hohenwarsleben	gw#
Hokkaido	ja#
Hokkaido Japan	ja#
Hokkaido, Japan	ja#
Hokukusho	ja#
Holloway, LA	lau
Hollywood	cau
Hollywood, CA	cau
Holman, NWT	ntc
Holmiae [Stockholm]	sw#
Holstebro	dk#
Holstebro, Denmark	dk#
Holsteinsborg	gl#
[Holsteinsborg]	gl#
Holte, Denmark	dk#
[Holton, KN]	knu
Holyhead	wlk
Holzminden	gw#
Homer, AK	aku
Honesdale, PA	pau
Hong Kong	cc#
[Hong Kong]	cc#
Honiton, England	enk
Honningsva^og	no#
Honningsva^og, Finnmark, Norway	no#
Honolulu	hiu
Honolulu, Hawaii	hiu
Honolulu, HI	hiu
Hook	enk
Hoorn	ne#
Hoorn, Netherlands	ne#
(Horn, Austria)	au#
Hornby, Lancaster	enk
Horsham, England	enk
Hot Springs, South Dakota	sdu
Houston	txu
Houston, Texas	txu
Houston, TX	txu
[Houston]	txu
Houten, Netherlands	ne#
[Houten, Netherlands]	ne#
Hove	enk
Hove, East Sussex	enk
Hove, England	enk
[Howth]	ie#
Hradec Kra^alove^a	xr#
Huddersfield	enk
Hull	enk
Hull and Beverley, England	enk
Hull, England	enk
Hull, Qc	quc
Hull, Qc.	quc
Hull, Que^abec	quc
Hull, Que.	quc
Hull, Quebec	quc
Hull, Quebec, Canada	quc
(Hull)	enk
[Hull]	enk
Humlebaek, Denmark	dk#
[Humlebaek, Denmark]	dk#
Hundested, Denmark	dk#
Hungary	hu#
Hungerford	enk
Huntingdon	enk
Huntingdon, UK	enk
Huntington Beach, CA	cau
[Huntington, NY]	nyu
Huntington, WV	wvu
Hurleyville, NY	nyu
Husum	gw#
Hveragerdi	ic#
Hyde Park, Ont.	onc
Hyde Park, Ontario	onc
Iachine, Quebec	quc
Iceland	ic#
ICES Headquarters	dk#
Ickenham	enk
(Iena)	xx#
Igloolik	ntc
[Igloolik, NWT]	ntc
IL	ilu
Ilfracombe	enk
Ilisagavik College	aku
Illinois	ilu
Inari, Finland	fi#
Inari/Ana^ar	fi#
Incheon	ko#
Incheon, Korea	ko#
India	ii#
Indiana, Pennsylvania	pau
Indianapolis	inu
Indianapolis & New York	inu
Indianapolis, IN	inu
Ingelstad	gw#
Innsbruck	au#
Innsbruck, Austria	au#
(Innsbruck)	au#
[Innsbruck]	au#
Instituto Anta^artico Chileno	cl#
Instituto Nacional del Hielo Continental Patago^anico.	ag#
Internet	xx#
[Internet]	xx#
Inukjuaj, Quebec	quc
Inukjuak, Que	quc
Inukjuak, Que^abec	quc
[Inukjuak, Que.]	quc
Inuvik	ntc
Inuvik, Canada	ntc
Inuvik, Northwest Territories	ntc
Inuvik, NT	ntc
Inuvik, NT, Canada	ntc
Inuvik, NWT	ntc
Invercargill	nz#
Invercargill, New Zealand	nz#
Invercargill, NZ	nz#
[Invercargill, NZ]	nz#
Inverness	stk
Inverurie	stk
Inwood, Ont.	onc
Iowa City	iau
Iowa City, IA	iau
Ipswich, London	enk
Iqaliut	ntc
Iqaluit	ntc
Iqaluit, NT	ntc
[Iqaluit, NT]	ntc
Iqaluit, NU	ntc
Iqaluit, Nunavut	ntc
Iqaluit, NWT	ntc
[Iqaluit]	ntc
Iqualiut, NT	ntc
Iqualuit, NU	ntc
Ireland	ie#
Irkusk	ru#
Irkustk	ru#
Irkutsk	ru#
Irving, CA	cau
Irving, TX	txu
Iserlohn	gw#
Isle of Lewis	stk
Isle of Wight	enk
Islip	enk
Issy-les-Moulineaux	fr#
Italian	it#
Italy	it#
Ithaca	nyu
Ithaca, New York	nyu
Ithaca, NY	nyu
Ithaca, USA	nyu
Ivrea?, Italy	it#
Izhev	ru#
Izhevsk	ru#
Jackson Hole, WY	wyu
Jackson, Wyoming	wyu
Jacksonville, OR	oru
Jacobshavn	dk#
Jaffrey, NH	nhu
[Jaffrey, NH]	nhu
Jakobshavn, Greenland	gl#
Jamaica, NY	nyu
Jamestown Foundation	xxu
Jamestown, North Dakota	ndu
Japan	ja#
Jefferson, N.C.	ncu
Jefferson, NC	ncu
Jefferson, NC and London	ncu
Jefferson, NC, USA	ncu
Jena	gw#
Jena, Germany	gw#
(Jena)	gw#
[Jena]	gw#
Jeneau, AK	aku
Jersey City, NJ	nju
Jerusalem	is#
Jo^unko^uping	sw#
Jo^unko^uping, Sweden	sw#
Joensuu	fi#
Joensuu, Finland	fi#
Johannesburg	sa#
(Johannesburg, Africana Museum)	sa#
Johannesburg, SA	sa#
Johannesburg, South Africa	sa#
(Johannesburg)	sa#
Johns Hopkins University Applied Physics Laboratory	mdu
Johor Darul Takzim	my#
Jokkmokk	sw#
Jokkmokk, Sweden	sw#
Journal and Science Union, University of Western Australia	wea
Ju^ulich	gw#
Ju^ulich, Germany	gw#
Jueneau, AK	aku
Jukkasja^urvi	sw#
Julianeha^ob	gl#
Julianehaab, Greenland	gl#
Juneau	aku
Juneau , AK	aku
Juneau, AK	aku
[Juneau, AK	aku
[Juneau, AK]	aku
Juneau, AL	aku
Juneau, Alaska	aku
(Juneau, Alaska)	aku
Juneau, USA	aku
[Juneau]	aku
Jyva^uskyla^u	fi#
Jyva^uskyla^u, Finland	fi#
Jyva^uskylsa^u, Finland	fi#
[Ka^ofjord, Norway]	no#
Ka^ogero^ud, Sweden	sw#
Ka^ullvik	fi#
[Kajaani, Finland]	fi#
Kakioka, Japan	ja#
Kalaallit Alakkeriviat	gl#
Kalinin	ru#
Kaliningrad	ru#
Kaluga	ru#
Kamchatka	ru#
Kamloops, BC	bcc
Kampala	ug#
Kanata, Ontario	onc
Kansa City, MI	miu
Kansas	ksu
Kansas City, MI	miu
Kapilano, West Vancouver	bcc
Karachi	pk#
Karachi, Pakistan	pk#
Karasjok	no#
Karasjok, Norway	no#
[Karasjok?]	no#
[Karasjok], Norway	no#
Karasjok/Ka^ara^as^vjohka, Norway	no#
Karasjokk, Norway	no#
Karisto Oy	fi#
Karlskrona, Sweden	sw#
Karlsruhe	gw#
Karlsruhe, Germany	gw#
Karlstad, Sweden	sw#
Kassel	gw#
Kastrup, Denmark	dk#
(Kastrup)	dk#
Katowice	pl#
Katowice, Poland	pl#
Kattowitz	pl#
Katwijk aan den Rijn, Netherlands	ne#
Kautokeino	no#
Kautokeino / Guovdageaidnu, Norway	no#
Kautokeino, Norway	no#
[Kautokeino, Norway]	no#
[Kautokeino]	no#
Kautokeino/Guovdageaidnu, Norway	no#
Kazakhstan	kz#
Kazan	ru#
Kazan'	ru#
Keele	enk
Keele, England	enk
Keele, Staffordshire	enk
Keil	xx#
KeKertarssuaK	gl#
[Kelowna, BC]	bcc
Kemerovo	ru#
Kemi, Finland	fi#
Kemija^urvi	fi#
Kempen	gw#
Kempten	gw#
Kendal	enk
Kendal, England	enk
Kenmore, WA	wau
Kensington, NSW	xna
Kent Town, SA	xra
Kent Town, SA, Australia	xra
[Kent, OH]	ohu
Kenthurst, NSW	xna
Kenthurst, NSW, Australia	xna
Ketchikan	aku
Ketchikan, AK	aku
Kevo	xx#
Kew	enk
Kew, Surrey	enk
Kew, VIC	vra
[Kew]	enk
Khabarovsk	ru#
Khabarovsk-Vladivostok	ru#
Khabarovsk, Vladivostok	ru#
Khanty-Mansiisk: nauchno-proizvodstvennyy tsentr po okhrane i ispol'zovaniyu pamyatnikov istorii i kul'tury	ru#
Khanty-Mansiysk	ru#
Khar'kov	un#
Kharbin	cc#
Kharkov, Ukraine	un#
Khatanga	ru#
Kidlington, Oxford	enk
Kiel	gw#
Kiel, Germany	gw#
[Kiel]	gw#
Kiev	un#
Kiev, Ukraine	un#
Kilmarnock	stk
King's Lynn	enk
(King's Lynn)	enk
[Kingsbridge]	enk
Kingston	onc
Kingston and Montre^aal	onc
Kingston and Montreal	onc
Kingston Ont	onc
Kingston upon Hull	enk
Kingston upon Thames	enk
Kingston upon Thames, England	enk
Kingston-on-Hull	enk
Kingston-upon-Thames	enk
Kingston-upon-Thames, England	enk
Kingston-upon-Thames, UK	enk
Kingston, Australia	xra
Kingston, ON	onc
Kingston, On.	onc
Kingston, Ont.	onc
(Kingston, Ont.)	onc
[Kingston, Ont.]	onc
Kingston, Ontario	onc
Kingston, Quebec	quc
Kingston, RI	riu
[Kingston, RI]	riu
Kingston, TAS	tma
Kingston, Tas.	tma
[Kingston, Tas.]	tma
[Kingston, TAS]	tma
Kingston, Tasmania	tma
(Kingston, Tasmania)	tma
Kingston, TASp	tma
Kingswood and London	enk
Kingswood, England	enk
Kingswood, Surrey	enk
Kingswood, Tadworth, Surrey	enk
Kington, Ont.	onc
Kinston, TAS	tma
Kio^zbenhavn	dk#
Kirkby Stephen	enk
Kirkby Stephen, Cumbria	enk
Kirkenes	no#
Kirkenes, Norway	no#
[Kirkenes, Norway]	no#
(Kirkenes)	no#
Kirkland, WA	wau
Kirkwall	stk
Kirkwall, Orkney	stk
Kirkwall, Scotland	stk
Kirov	ru#
Kirovsk	ru#
[Kirriemuir]	stk
Kiruna	sw#
Kiruna, Sweden	sw#
[Kiruna]	sw#
Kishinev	mv#
Kitami	ja#
Kitchener, Ont.	onc
Kiyev	un#
Kjo^abenhavnime	dk#
Kjo^ubenhavn	dk#
(Kjo^ubenhavn)	dk#
Kjo^zbenhaven	dk#
Kjo^zbenhavn	dk#
Kjo^zhenhavn	dk#
Kjobenhavn	dk#
Klaebu, Norway	no#
Klagenfurt	au#
Kleve, Germany	gw#
[Kluwer]	xx#
Knockdow	stk
Knoxville	tnu
Knoxville, TN	tnu
Ko^ubenhavn	dk#
Ko^uln	gw#
Ko^uln and Berlin	gw#
Ko^uln, Germany	gw#
(Ko^uln)	gw#
Ko^unigsberg	gw#
(Ko^unigsberg)	gw#
Ko^unigstein	gw#
Ko^unigstein, Germany	gw#
(Ko^uzlo^uny)	hu#
Ko^zbenhaven	dk#
Ko^zbenhavn	dk#
Ko^zbenhavn & Kristiania	dk#
(Ko^zbenhavn)	dk#
[Ko^zbenhavn]	dk#
Ko^zbenhavnime	dk#
Ko^zbnehavn	dk#
Ko^zvenhavn	dk#
[Kobe]	ja#
Kobenhavn	dk#
Kobenhavn K	dk#
(Kobenhavn)	dk#
(Koblenz)	gw#
Kodiak, AK	aku
Koeln	gw#
Koenigstein	gw#
Kola	ru#
Koln	gw#
Koln, Germany	gw#
Kolskiy Nauchnyy Tsentr RAN	ru#
Komi	ru#
Komi Nauchnoye Izdatel'stvo	ru#
Komsomol'sk na Amure	ru#
Kondopoga	ru#
Konigsberg	gw#
Konoura	ja#
Konoura, Japan	ja#
[Konoura]	ja#
Kopenhagen	dk#
Korea	ko#
Kosmos	xx#
Kotka, Finland	fi#
Kotkino, Nar'yan-Mar	ru#
Kotzebue, AK	aku
[Kotzebue, AK]	aku
Kotzebue, Alaska	aku
Kotzebue, Alaska, USA	aku
Krako^aw	pl#
Krako^aw, Poland	pl#
(Krako^aw)	pl#
[Krako^aw]	pl#
Krakow	pl#
Krasnoyarsk	ru#
Kristiana	no#
Kristiania	no#
Kristiania (Oslo)	no#
Kristiania, Alb	abc
(Kristiania)	no#
Kristianiast	no#
Kristiansand	no#
Kristiansand S.	no#
Kristiansand, Norway	no#
Kristianstad, Sweden	sw#
Kristiansund, Norway	no#
Kronshagen	gw#
KUAC-TV	aku
Kuala Lumpur	my#
Kudymkar	ru#
kujata^hne	gl#
Kunstkammer	xx#
Kuopio, Finland	fi#
Kursk	ru#
Kustannusosakeyhtio^u Kirja	fi#
[Kuujjuaq, NU]	quc
Kuujjuaq, Que	quc
Kuujjuaq, Que.	quc
Kyoto	ja#
Kyzyl	ru#
L^zo^adz^a	pl#
(L^Zo^adz^a)	pl#
L^zodz^a, Poland	pl#
L.G. Hanscom Field, MA	mau
L'vov	un#
La Creche, France	fr#
La Fayette, IN	inu
La Grange Park, IL	ilu
La Haye	ne#
La Haye [The Hague]	ne#
La Jolla	cau
La Jolla, CA	cau
La Plata	ag#
(La Plata)	ag#
[La Plata]	ag#
La Re^aunion, France	fr#
La Rochelle	fr#
La Ronge, Sask.	snc
[La Ronge, Sask.]	snc
La Ronge, SK, Canada	snc
La Spezia, Italy	it#
Labrador	nfc
Lachine, Que	quc
Ladd Air Force Base, Alaska	aku
Lafayette, CA	cau
Lafayette, CO	cou
Lagrasse, France	fr#
Lahr	gw#
Lahti	fi#
[Laibach]	xv#
Lajes do Pico, Ac^cores	po#
Lake Arrowhead, CA	cau
Lake Orion, MI	miu
Lake Park, FL	flu
Lakselv, Norway	no#
Lammi, Finland	fi#
Lancaster	enk
Lancaster, Ont.	onc
Lancaster, PA	pau
(Lancaster, PA)	pau
[Lancaster]	enk
Landover, MD	mdu
Lane Cove, NSW	xna
Langensalza	gw#
Langley, B.C.	bcc
Langley, BC	bcc
Lanham, Maryland	mdu
Lanham, MD	mdu
Lanham, NY	nyu
Lantzville	bcc
Lanzhou	cc#
Lanzhou, China	cc#
Laramie, WY	my#
Larvik	no#
Larvik, Norway	no#
(Larvik)	no#
Las Cruces, USA	nmu
Las Vegas, NV	nvu
Launceston	tma
Launceston, Australia	tma
Launceston, TAS	tma
Launceston, Tasmania	tma
Lausanne	sz#
Lausanne, Switzerland	sz#
Lausannes	sz#
Laval, Que^abec	quc
Laval, Quebec	quc
Lavenham	enk
LaVergne, TN	tnu
[Lavrentiya]	ru#
Lawrence	ksu
Lawrence, KA	ksu
Lawrence, Kansas	ksu
Lawrence, KS	ksu
[Lawrence, KS]	ksu
Lawrence. KS	ksu
Le Cha^hteau-d'Olonne, France	fr#
Le Faou, France	fr#
Le Havre	fr#
Le Havre and Rouen	fr#
(Le Havre)	fr#
[Le Havre]	fr#
Le Jas des Batarins	fr#
Le Mans, France	fr#
Le^avis, QC	quc
Leamington Spa	enk
Lebanon, New Hampshire	nhu
Ledbury	enk
Leeds	enk
Leeds, UK	enk
[Leeds]	enk
Leghorn	it#
Lehre	gw#
Lehre, Germany	gw#
Leicester	enk
(Leicester University Press)	enk
Leiden	ne#
Leiden, Holland	ne#
Leiden, Netherlands	ne#
(Leiden)	ne#
Leigh-on-Sea	enk
Leikanger	no#
Leikanger, Norway	no#
Leipsiz	gw#
Leipzig	gw#
Leipzig and Berlin	gw#
Leipzig und Heidelberg	gw#
Leipzig, Germany	gw#
Leipzig, Jena, Berlin	gw#
(Leipzig)	gw#
[Leipzig]	gw#
(Leipzig/Ko^uln)	gw#
Lejre	dk#
Lelystad, The Netherlands	ne#
Lemberg	un#
Lemvig	dk#
Lemvig, Denmark	dk#
Lenigrad	ru#
Leningrad	ru#
Leningrad, Moscow	ru#
(Leningrad)	ru#
Leningrad)	ru#
[Leningrad]	ru#
(Leningrad0	ru#
Lenningen	lu#
Lenningrad	ru#
Leominster	enk
Les Ulis, France	fr#
[Les Ulis, France]	fr#
Lesjaskog	no#
Letchworth	enk
Letchworth, Hertfordshire	enk
Leuden	ne#
Leusden, Netherlands	ne#
Leuven	ne#
Leverkusen	gw#
Leverkusen, Gemany	gw#
Leverkusen, Germany	gw#
Lewes	enk
[Lewes, England]	enk
Lewes, Sussex, England	enk
Lewiston, ME	meu
Lewiston, NY	nyu
Lexington	kyu
Lexington, KY	kyu
Leyde	ne#
Leyden	ne#
Leyden and Utrecht	ne#
Leyden, Holland	ne#
Leylstad	ne#
Lichtenau	gw#
Lidingo	sw#
Lidingo^u	sw#
Lidingo^u, Sweden	sw#
Lidingo, Sweden	sw#
(Lie^age)	be#
Lie^gge	be#
Lie^gge, France	be#
Liechtenstein	lh#
Liege	be#
Ligonier, PA	pau
Lille	fr#
Lillehammer, Norway	no#
Lillestro^zm	no#
Lima	pe#
(Lima)	pe#
[Lima]	pe#
Limoges	fr#
Lincoln	enk
Lincoln, NB	nbu
Lincoln, NE	nbu
Lincoln, Nebraska	nbu
Lindgo, Sweden	sw#
Linko^uping	sw#
Linko^uping, Sweden	sw#
(Linko^uping)	sw#
Linz, Austria	au#
Lipsiae	gw#
Lisboa	po#
Lisbon	po#
(Lisbon)	po#
[Lisbon]	po#
Liskeard	enk
Lisse [Netherlands]	ne#
Lisse, etc.	ne#
Lisse, The Netherlands	ne#
Litchfield Park, AZ	azu
Little Logaston, Herefordshire	enk
Littleton, CO	cou
Littleton, Colorado	cou
[Livermore, CA]	cau
Liverpool	enk
(Liverpool)	enk
[Liverpool]	enk
Livingston	stk
Ljubljana	xv#
[Ljubljana]	xv#
(Lo^adz^a)	pl#
[Loanhead]	stk
Lodz, Poland	pl#
Lofoten, Norway	no#
Logan, UT	utu
Logron^to	sp#
Lonay	sz#
Loncoln, NB	nbu
Londom	enk
London	enk
London [Exeter printed]	enk
London and Cambridge	enk
London and Edinburgh	enk
London and Glasgow	enk
London and Leipsic	enk
London and New Lork	enk
London and New York	enk
London and Southampton	enk
London and Sydney	enk
London and Tonbridge	enk
London and Toronto	enk
London and Washington, DC	enk
London etc.	enk
(London Zoological Society)	enk
London,	enk
London, Basingstoke	enk
London, Bombay, Sidney	enk
London, Edinburgh and Glasgow	enk
London, England	enk
London, etc.	enk
London, Glasgow	enk
(London, Glasgow)	enk
London, New York	enk
London, New York and Toronto	enk
London, New York, Toronto	enk
London, Ont	onc
London, Ont.	onc
[London, Ont.]	onc
London, Ontario	onc
(London, Ontario)	onc
(London, Orders and Medals Research Society)	enk
London, Sydney and Toronto	enk
London, Sydney, Auckland and Toronto	enk
London, Sydney, Toronto	enk
London, Toronto, etc.	ekn
[London,Ont.]	onc
London; Auckland	enk
[London?]	enk
(London)	enk
London)	enk
[London]	enk
[Long Beach, CA]	cau
Long Branch, NJ	nju
Long Eaton, UK	enk
Long Island, NY	nyu
Long Sutton, England	enk
Longchamp, France	fr#
Longmire, WA	wau
Longyearbyen	no#
Longyearbyen and Oslo	no#
Longyearbyen, Norway	no#
[Longyearbyen, Norway]	no#
Longyearbyen, Svalbard	no#
Lonson	enk
Loreto	pau
[Loretta, PA]	pau
Los Alamitos, CA	cau
Los Altos, CA	cau
Los Altos, California	cau
Los Angeles	cau
Los Angeles, CA	cau
(Los Angeles)	cau
Lossburg, Germany	gw#
Loughborough	enk
Loughton	enk
Louisiana	lau
(Lourdes)	fr#
Louvain	be#
(Louvain)	be#
Loveland, CO	cou
Loviisa, Finland	fi#
Lovozero	ru#
Lower Hutt	nz#
Lower Hutt, New Zealand	nz#
Lower Hutt, NZ	nz#
Lowestoft	enk
Lu^ubeck	gw#
Luanda, Angola	ao#
Lubbock, Texas	txu
Lubeck	gw#
Lublin	pl#
Lublin, Poland	pl#
Lucerne, Switzerland	sz#
Lucknow	ii#
Ludwigshafen, Germany	gw#
Lugano, Switzerland	sz#
Luglio	it#
Lulea	sw#
Lulea^a	sw#
Lulea^o	sw#
Lulea^o, Sweden	sw#
(Lulea^o)	sw#
[Lulea^o]	sw#
Lulea, Sweden	sw#
Lund	sw#
Lund, Sweden	sw#
(Lund)	sw#
[Lund]	sw#
Lunds	sw#
Lutherstadt Wittenberg	gw#
Luton, Bedfordshire	enk
Luxembourg	lu#
[Luxembourg]	lu#
Luzern	sz#
Lvov	un#
Lwow-Warszawa	un#
Lwow, Austria; Paris	un#
(Lwow, Austria)	un#
Lyden	xx#
Lymington	enk
Lyngby	dk#
Lyngby, Danmark	dk#
Lyngby, Demark	dk#
Lyngby, Denmark	dk#
[Lyngby]	dk#
Lynge	dk#
Lynge, Denmark	dk#
Lynnwood Ridge, South Africa	sa#
Lyon	fr#
Lyon, France	fr#
(Lyon)	fr#
Lyons	fr#
Lysaker	no#
Lysaker, Norway	no#
[Lysaker, Norway]	no#
MA	mau
Ma^hcon, France	fr#
Maastricht	ne#
Macclesfield, UK	enk
Mackinac Island	miu
Macquarie Park, Aus.	xna
Madeira Park, BC	bcc
Madira Park, BC	bcc
Madison	ilu
Madison, IL	ilu
Madison, Milwaukee	wiu
Madison, WI	wiu
Madison, WI.	wiu
Madison, Wisconsin	wiu
Madrid	sp#
(Madrid)	sp#
[Madrid]	sp#
Madsion, WI	wiu
Magadan	ru#
Magadan, Russia, and Anchorage AK	ru#
[Magadan]	ru#
Magadanskoye Knizhnoye Izdatel'stvo	ru#
Magadna	ru#
Magallanes, Chile	cl#
Magnitogorsk	ru#
Mahwah, NJ	nju
Maidenhead	enk
Maidenhead, Berks.	enk
Maidstone	enk
Maidstone, England	enk
(Maidstone)	enk
[Maine]	meu
Mainz-Mu^unchen, Germany	gw#
Maksimkin Yar	ru#
Malden, MA	mau
Mallemoisson, France	fr#
[Malmesbury]	enk
Malmo^u	sw#
Malmo^u, Ko^upenhamn, Berlin	sw#
Malmo^u, Sweden	sw#
[Malmo^u, Sweden]	sw#
Malvern	enk
Malvern Wells	enk
Malvern, UK	enk
Malvern, Worcs	enk
Manchecourt, France	fr#
Manchester	enk
Manchester and London	enk
Manchester, England	enk
(Manchester)	enk
Manhattan Beach, CA	cau
(Manila-Shanghai)	ph#
Manila, Philippines	ph#
Manitoba	mbc
(Manitoba)	mbc
Mankato, MN	mnu
Mannheim	gw#
Manotick	onc
Manotick, ON	onc
Mansfield, Notts	enk
Maple Creek, Saskatchewan	snc
Maplewood, NJ	nju
[Mar del Plata]	ag#
Marburg	gw#
(Maritime Museum, British Columbia)	bcc
Markdale, Ontario	onc
Markham, ON, Canada	onc
Markham, Ont	onc
Markham, Ont.	onc
[Markham, Ont.]	onc
Markham, Ontario	onc
Marlborough, UK	enk
Marseille	fr#
Marseille, France	fr#
Marseilles	fr#
Marshall, MN	mnu
Martinborough, NZ	nz#
Mascot, NSW	xna
Massachusetts	mau
Maxwell , AL	alu
[Maxwell Air Force Base, Ala.]	alu
Maxwell Air Force Base, Alabama	alu
[Maxwell Air Force Base, Alabama]	alu
Maxwell Field, Alabama	alu
Mayo	ykc
Mayo, Yukon	ykc
McKinleyville, CA	cau
Mclean, VA	vau
McLean, Virginia	vau
McMurdo, Antarctica	ay#
Me^arida	xx#
Meadville, PA	pau
Mebourne	vra
Mechanicsburg, PA	pau
Mechanicsburg, PA., USA	pau
Medford, MA	mau
Melbourn	vra
Melbourne	vra
Melbourne, Australia	vra
(Melbourne, Commonwealth Public Service Professional Officers' Association)	vra
Melbourne, VIC	vra
Melbourne, Vic.	vta
[Melbourne, Vic.]	vta
Melbourne, Victoria	vra
(Melbourne?)	vra
(Melbourne)	vra
[Melbourne]	vra
Melsungen	gw#
Memphis, TN	tnu
(Menasha, WI)	wiu
Mendoza, Argentina	ag#
[Mendoza, Argentina]	ag#
(Mendoza)	ag#
Menlo Park	cau
Menlo Park, CA	cau
Menlo Park, California	cau
[Menlo Park, California]	cau
Menston	enk
Meppel, Holland	ne#
Meppen	gw#
Mercersberg, PA	pau
Merrickville, Ont.	onc
Mesnil-sur-l'Estre^ae	fr#
Messina Firenze	it#
(Messina)	it#
Metz, France	fr#
(Metz)	fr#
Meung-sur-Loire	fr#
Mexico	mx#
Mexico City	mx#
(Mexico)	mx#
[Mexico]	mx#
(Miami, FL)	flu
(Miami),	flu
Michaud	xx#
Michigan	miu
Middelburg, Netherlands	ne#
Middlebury, VT	vtu
Middlesborough	enk
Middlesborough, Cleveland	enk
Middlesex	enk
Middlesex, England	enk
Middleton, CT	ctu
Middleton, WI	wiu
Middletown, CN	ctu
Middletown, CT	ctu
Midnapore, Alberta	abc
Mies, Switzerland	sz#
Milan	it#
(Milan)	it#
Milano	it#
Milano, Italy	it#
(Milano)	it#
[Miljo^zmerket	no#
Millbrook, Ont.	onc
Millers Point, NSW	xna
Milnthorpe	enk
Milnthorpe, Cumbria	enk
Milson Point, NSW	xna
Milton Keynes	enk
Milton Keynes, UK	enk
Milwaukee	wiu
Milwaukee, WI	wiu
Minden, BFPO 29	gw#
Minden, Germany	gw#
Mineola, NY	nyu
Minneapolis	mnu
Minneapolis, MN	mnu
[Minneapolis, MN]	mnu
Minnesota	mnu
Minnesota, MN	mnu
Minnetonka, MN	mnu
Minnetonka, USA	mnu
Minocqua, WI	wiu
Minsk	bw#
Mirnyy	ru#
Mississauga, Ont	onc
Mississauga, Ont.	onc
Mississauga, Ontario	onc
Mississippi	msu
Missoula, MO	mou
Missoula, MT	mtu
Missoula, MT 59806	mtu
Missoula, MT, USA	mtu
Mitcham, Surrey	enk
Mitcham, Surrey, England	enk
Miyagi	ja#
MN	mnu
Mo, Norway	no#
Mocsow	ru#
Modena	it#
Modena, Italy	it#
Molotov	xx#
Mombetsu	ja#
Mombetsu, Hokkaido	ja#
Monaco	mc#
(Monaco)	mc#
[Monaco]	mc#
Monro, MN	mnu
Monrovia, Liberia	lb#
Mons	be#
Monte-Carlo	mc#
Monterey (California)	cau
Monterey, CA	cau
Monterey, California	cau
Montevideo	uy#
Montevideo, Uruguay	uy#
(Montevideo)	uy#
Montgomery	xx#
Montigny le Bretonneux	fr#
Montivedeo	uy#
Montlouis-sur-Loire	fr#
Montpelier, Vermont	vtu
Montr^aal	quc
Montre^aal	quc
Montre^aal, QC	quc
Montre^aal, Que.	quc
Montre^aal, Que.,	quc
(Montre^aal)	quc
[Montre^aal]	quc
Montre^al	quc
Montrea^al	quc
Montreal	quc
Montreal & Kingston	quc
Montreal and Geneva	quc
Montreal and Kingston	quc
Montreal and London	quc
Montreal, Canada	quc
Montreal, P.Q.	quc
Montreal, PQ	quc
Montreal, QC	quc
Montreal, Qc.	quc
Montreal, Que	quc
Montreal, Que.	quc
[Montreal, Que]	quc
Montreal, Quebec	quc
(Montreal)	quc
[Montreal]	quc
Montrose	xx#
Montrose, CA	cau
Montrouge, Cedex	fr#
Monument, CO	cou
Moonah, Tas.	tma
Moonbeam, ON	onc
Moonbeam, Ontario	onc
Moore Haven, FL	flu
Moose, Wyoming	wyu
Moreton-in-Marsh	enk
Morgantown, WV	wvu
Morges	sz#
Morges, Switzerland	sz#
Mornington, Vic	vra
Morpeth	enk
Morrisburg, Ont	onc
Morristown, NJ	nju
Morwell, Victoria	vra
Mos, Spain	sp#
Moscou	ru#
Moscov	ru#
Moscow	ru#
(Moscow	ru#
Moscow and Leningrad	ru#
(Moscow and Leningrad)	ru#
Moscow and Washington	ru#
Moscow-Leningrad	ru#
Moscow-Newtonville	ru#
Moscow, ID	idu
Moscow, Idaho	idu
Moscow, Leningrad	ru#
(Moscow, Leningrad)	ru#
Moscow, Ogiz	ru#
Moscow?	ru#
[Moscow?]	ru#
(Moscow)	ru#
[Moscow]	ru#
Moscva	ru#
Mosjo^zen, Norway	no#
Mosjoen, Norway	no#
Moskova	ru#
Moskow	ru#
Moskva	ru#
Moskva @* Leningrad	ru#
Moskva and Leningrad	ru#
Moskva Arkhangel'sk	ru#
Moskva-Leningrad	ru#
Moskva-Magadan	ru#
Moskva-Vashington	ru#
Moskva, Leningrad	ru#
Moskva; Paris	ru#
(Moskva)	ru#
[Moskva]	ru#
Moskva/Novosibirsk	ru#
MoskvaM	ru#
Moskya	ru#
Moss	no#
Moss, Norway	no#
Moulis, France	fr#
Mount Rumney, Tas.	tma
Msocow	ru#
Mt. Prospect, IL	ilu
Mt. Rumney, TAS	tma
Mu^unchen	gw#
Mu^unchen and Berlin	gw#
Mu^unchen-Solln	gw#
Mu^unchen-Wien	gw#
Mu^unchen, Germany	gw#
(Mu^unchen)	gw#
[Mu^unchen]	gw#
Mu^unster	gw#
Mu^unster, Germany	gw#
Mumbai, India	ii#
Munchen	gw#
Munchen, Germany	gw#
(Munchen)	gw#
Munchen/Grunwald	gw#
Munich	gw#
Munich, Germany	gw#
(Munich)	gw#
Munising, MI	miu
Munster	gw#
Murmansk	ru#
Murmansk, Moskva	ru#
Murnau	gw#
Murnau, Germany	gw#
Murphy, OR	oru
Musashino	ja#
Museo dell'Antartide	it#
Mystic	ctu
Mystic, CN	ctu
[Mystic, CN]	ctu
Mystic, Connecticut	ctu
Mystic, CT	ctu
[n,p.]	xx#
[n. p.]	xx#
N. Quincy, MA	mau
[n.d.]	xx#
n.p.	xx#
[n.p.]	xx#
n.p.]	xx#
[n.p.] :	xx#
[n.p]	xx#
n.pl.	xx#
[n.pl.]	xx#
[n.pl]	xx#
[n.pu.]	xx#
[n.pub.]	xx#
[N.W.T.]	ntc
N.Y.	nyu
Naatick,MA	mau
Naberth, Wales	wlk
Nadym	ru#
[Naerum]	dk#
Nagaoka-shi, Niigata-ken	ja#
Nagoya	ja#
Nagoya, Japan	ja#
Nain, Labrador	nfc
Nairobi	ke#
Nairobi, Kenya	ke#
Nakano, Japan	ja#
Nakhodka	ru#
Namur	fr#
Namur, France	fr#
Nanaimo	bcc
Nanaimo, BC	bcc
(Nanaimo, BC)	bcc
Nanaimo, British Columbia	bcc
Nancy, France	fr#
(Nancy)	fr#
Nanterre	fr#
Nantes	fr#
Nantucket	mau
Nantucket, MA	mau
Naples	it#
Naples, Italy	it#
Napoli	it#
Napoli, Italy	it#
(Napoli)	it#
Nar'yan Mar	ru#
Nar'yan-Mar	ru#
Narkomzdrav	ru#
Narragansett	riu
Narssaq	gl#
Narvik	no#
Nary'an-Mar	ru#
Naryan-Mar	ru#
Nashville	tnu
Nashville, TN	tnu
Natick, MA	mau
Natick, Massachusetts	mau
National Educational, Scientific and Cultural Organization	fr#
Nauka	pl#
Naumburg a.S.	gw#
Nebraska	nbu
Neerlandia, Alb.	abc
(Neisse)	pl#
Nelson	bcc
Nelson, BC	bcc
Nelson, New Zealand	nz#
Nelson, NZ	nz#
Nenana, AK	aku
Nendeln, Liechtenstein	lh#
Nendeln/Liechtenstein	lh#
Nenthead	enk
Nepean, Ontario	onc
Neptune City, NJ	nju
Neptune, NJ	nju
Netherlands	ne#
Neucha^htel	sz#
Neucha^htel, Switzerland	sz#
(Neucha^htel)	sz#
Neuchatel	sz#
Neuchatel and Paris	sz#
Neuilly	fr#
Neuilly sur Seine	fr#
Neuilly-sur-Seine	fr#
Neumu^unster	gw#
Neumu^unster, Germany	gw#
Nevada City	cau
Nevada, USA	nvu
New Aiyansh, BC	bcc
New Bedford	ctu
New Bedford, CT	ctu
(New Bedford, Dartmouth Historical Society)	mau
New Bedford, MA	mau
[New Bedford, MA]	mau
New Bedford, Mass.	mau
New Bedford, Massachusetts, USA	mau
New Brunswic, NJ	nju
New Brunswick	nju
New Brunswick, N.J.	nju
New Brunswick, New Jersey	nju
New Brunswick, NJ	nju
New Dehli	ii#
New Delhi	ii#
(New Delhi)	ii#
[New Delhi]	ii#
New Haven	enk
New Haven and London	enk
New Haven CT	ctu
New Haven, CN	ctu
New Haven, Connecticut	ctu
New Haven, CT	ctu
(New Haven)	ctu
New Jersey	nju
New Liskeard, ON, Canada	onc
New London	ctu
New Malden, England	enk
New Mexico	nmu
New Milford, CN	ctu
New Smyrna Beach, FL	flu
New Town, TAS	tma
New York	nyu
New York ; Oxford	nyu
New York ; Philadelphia, PA	nyu
New York & London	nyu
New York and London	nyu
(New York and London)	nyu
New York and Oxford	nyu
(New York and Philadelphia)	nyu
New York and Seattle	nyu
New York and Stuttgart	nyu
New York and Toronto	nyu
New York City	nyu
New York, Chicago, Toronto, London, Edinburgh	nyu
New York, etc.	nyu
New York, London	nyu
New York, London and Toronto	nyu
New York, London etc	nyu
New York, N.Y.	nyu
New York, NY	nyu
New York, NY, USA	nyu
[New York, NY]	nyu
New York, Toronto, London	nyu
New York, USA	nyu
New York; Basingstoke	nyu
(New York?)	nyu
(New York)	nyu
[New York]	nyu
New Zealand	nz#
[New Zealand]	nz#
New-York	nyu
Newark	xx#
Newark, DE	deu
[Newark, DE]	deu
Newark, NJ	nju
Newberg	oru
Newbury	enk
Newcastle upon Tyne	enk
Newcastle-upon-Tyne	enk
(Newcastle-upon-Tyne)	enk
[Newcastle, Ont.]	onc
[Newcastle]	xx#
Newnham, Australia	tma
Newport Beach, CA	cau
Newport, Rhode Island	riu
Newton Abbot	enk
Newton Abbot Devon	enk
Newton Abbot, Devon	enk
Newton Abbot, England	enk
Newton Abbott	enk
Newton Centre, MA	mau
Newton St. Margarets	enk
Newtonville, MA	mau
[Newtown]	wlk
Niagara Falls, Ontario	onc
[Niagara Falls, Ontario]	onc
Niigata	ja#
Niihari, Ibaraki	ja#
Nijkerk, Netherlands	ne#
Nijmegen, Netherlands	ne#
Nijmegen, The Netherlands	ne#
Niort, France	fr#
Nitero^al	bl#
Niwot, CO	cou
Nizhnevartovsk	ru#
NJ	nju
Noble Park, VIC	vra
Nome, AK	aku
Noordwiijk, Netherlands	ne#
Noordwijk	ne#
Noordwijk, Netherlands	ne#
Noordwijk, The Netherlands	ne#
[Noordwijk]	ne#
Nora, Sweden	sw#
Norderstedt	gw#
Norderstedt, Germany	gw#
Nordnorsk	no#
Nordwijk	ne#
Norfolk	enk
Norfolk Island, Australia	nx#
Norfolk, VA	vau
Noril'sk	ru#
Norilsk	ru#
Norman	oku
Norman Wells, NT	nuc
Norman, OH	ohu
Norman, OK	oku
[Norman, OK]	oku
Norman, Oklahoma	oku
(Norman)	oku
Norrbottens Museum	sw#
Norrko^uping	sw#
Norrko^uping, Sweden	sw#
Norrkoping, Sweden	sw#
Norrlo^uping	sw#
North Bay, Ontario	onc
North Beach, WA	wau
North Berwick	stk
North Billerica, Massachusetts	mau
North Conway, NH	nhu
North Haven, CT	ctu
North Mankato	mnu
North Quincy, Mass.	mau
North Salt Lake, UT	utu
North Scituate, MA	mau
North Slope Borough, AK	aku
North Vancouver	bcc
North Vancouver, BC	bcc
North York, Ont.	onc
Northampton, MA	mau
Northanpton, MA,USA	mau
Northfield, MN	mnu
[Northfield, MN]	mnu
Northfield, Vermont	vtu
Northfield, VT	vtu
Northfield, Vt.	vtu
Northleach	enk
Northwest Territories	ntc
[Northwest Territories]	ntc
Norwalk, CT	ctu
Norway	no#
[Norway]	no#
Norwich	enk
Norwich, CT	ctu
Norwich, England	enk
Norwich, VT	vtu
[Norwich]	enk
Norwood, MA	mau
Norwood, New Jersey	nju
Norwood, South Australia	xra
Noskva	xx#
[not given]	xx#
Notre Dame, IN	inu
Nottingham	enk
Nottingham, England	enk
[Nottingham]	enk
Novara, Italy	it#
Novato, CA	cau
Novaya Chara	ru#
Novgorod	ru#
Novisibirsk	ru#
Novosibirisk	ru#
Novosibirks	ru#
Novosibirsk	ru#
Novosibirsk Yakutsk	ru#
Novosibirsk, Russia	ru#
(Novosibirsk)	ru#
Novosobirsk	ru#
Novsibirsk	ru#
NSTL Station, Mississippi	miu
NSTL, Mississippi	miu
Nu^hk	gl#
Nu^hngme	gl#
Nu^urnburg	gw#
Nunavik	quc
Nunavik, Canada	qcu
Nunavut	nuc
Nuneaton	enk
Nuremberg	gw#
Nuuk	gl#
Nuuk, Greenland	gl#
Nuuk, Greenland / Copenhagen	gl#
[Nuuk, Greenland]	gl#
Nuuk; Ko^zbenhavn	gl#
Nuuk?	gl#
[Nuuk?]	gl#
[Nuuk]	gl#
Nuussuaq	gl#
NWT	ntc
NWT, Canada	ntc
NY	nyu
NY, USA	nyu
Nyko^zbing F., Denmark	dk#
Nyons	fr#
NZ	nz#
O^Urebro	sw#
O^urebro, Sweden	sw#
O^urkelljunga, Sweden	sw#
O^Ustersund	sw#
O^ustersund (Sweden)	sw#
O^Ustersund, Sweden	sw#
[O^Ustersund]	sw#
O^uvertornea^o	sw#
(O^uvertornea^o)	sw#
O^Zstera^os, Norway	no#
O^Zystese, Norway	no#
Oak Ridge, Tennessee	tnu
Oak Ridge, TN	tnu
Oakham	enk
Oakland, CA	cau
Oakville, ON	onc
Oakville, Ont.	onc
Oamaru	nz#
Oamaru, NZ	nz#
[Oamaru]	nz#
Oban	stk
Oberlin, OH	ohu
Oberpfaffen	gw#
Oberpfaffenhofen	gw#
Oberpfaffenhofen, Germany	gw#
Oberursel	gw#
Obninsk	ru#
Odense	dk#
Odense, Denmark	dk#
Odessa	un#
Offenbach a. M.	gw#
Offenbach am Main	gw#
Offenbach am Main, Germany	gw#
Office of Polar Programs	vau
Offut Air Force Base, NE	nbu
Offutt Air Force Base, NE	nbu
OH	ohu
Ohcejohka (Utsjoki), Finland	fi#
Ohcejohka/Utsjoki, Finland	fi#
Ohio	ohu
Ohio, OH	ohu
[Ohlendorf/Luhe]	gw#
Ohmura, Japan	ja#
Oklahoma	oku
Oklahoma, OK	oku
Old Basing	enk
Old Harlow	enk
Old Saybrook, CT, USA	ctu
Oldenburg and Hamburg	gw#
Oldenburg, Berlin	gw#
Oldenburg/Hamburg	gw#
Oldendorf/Luhe	gw#
Oldendorf/Luhe, Germany	gw#
[Oldendorf/Luhe]	gw#
[Olendorf/Luhe]	gw#
Olion	xx#
Olso	no#
(Olso)	no#
Olten-Bern	sz#
Olympia, WA	wau
Omaha, NE	nbu
Omsk	re#
On-line publication	xx#
Ontario	onc
Ontario ISSN 0068-7790	onc
Ontario, Canada	onc
Oosterhout	ne#
Oosterhout N.B., The Netherlands	ne#
Oosterhout, NB	ne#
Oppenheim	gw#
Oregon	oru
Orlando	flu
Orlando etc.	flu
Orlando, etc	flu
Orlando, FA	flu
Orlando, FL	flu
Orlando, Florida	flu
Orle^aans, France	fr#
Orleans	fr#
Orleans, France	fr#
[Orono, Maine]	meu
Orono, ME	meu
[Orono, ME]	meu
Orsainville	fr#
Orsay	fr#
Orwell, Royston, England	enk
Osaka	ja#
Osaka, Japan	ja#
[Osaka]	ja#
Oshtemo, MI	miu
Oslo	no#
Oslo Lufthavn	no#
Oslo-Bergen-Tromso^z	no#
Oslo, Bergen, Tromso^z	no#
Oslo, Copenhagen and Stockholm	no#
Oslo, Norway	no#
[Oslo?]	no#
(Oslo)	no#
[Oslo]	no#
[Oslo], Norway	no#
Ostermundigen (Bern)	sz#
Ostfildern, Germany	gw#
Oststeinbek, Germany	gw#
Oswestry	enk
Oswestry, England	enk
Oswestry, Shropshire	enk
Otago, New Zealand	nz#
Otaniemi	fi#
Otley	enk
Ottawa	onc
Ottawa and Vancouver	onc
Ottawa,	onc
Ottawa, Canada	onc
Ottawa, Canada, Department of Energy Mines and Resources, Glaciology Subdivision	onc
(Ottawa, National Museum of Natural Sciences)	onc
Ottawa, ON	onc
Ottawa, Ont	onc
Ottawa, Ont.	onc
[Ottawa, Ont.]	onc
[Ottawa, ONT]	onc
Ottawa, Ontario	onc
[Ottawa, Ontario]	onc
[Ottawa?]	onc
(Ottawa)	onc
[Ottawa]	onc
[[Ottawa]	onc
[Ottery St. Mary]	enk
Ottowa	onc
Ottowa, ONT	onc
[Ottowa]	onc
Ouje^a-Bougoumou, Que	quc
Oulu	fi#
Oulu, Finland	fi#
[Oulu, Finland]	fi#
(Oulu)	fi#
Outreau, France	fr#
Outremont, QC	quc
Outremont, Que.	quc
Owen Sound, ON, Canada	onc
Oxford	enk
Oxford and Edinburgh	enk
Oxford and Providence, RI	riu
Oxford, etc	enk
Oxford, UK	enk
(Oxford)	enk
[Oxford]	enk
Oxfordshire	enk
Pacific Palisades	cau
Pacifica, CA	cau
(Paderborn)	gw#
Padova	it#
Padova, Italy	it#
Padua	it#
Pairs	xx#
Paisley	stk
Palana	ru#
Palisades, NY	nyu
Palmer	aku
Palmer, AK	aku
Palmerston North	nz#
Palmerston North, New Zealand	nz#
Palo Alto	cau
Palo Alto, CA	cau
Pamplona	sp#
Panama City, Florida	flu
Pangnirtung NT	nuc
[Pangnirtung, NT]	nuc
Pangnirtung, NU	nuc
Pangnirtung, Nunavut	nuc
Pangnirtung, NWT	nuc
Paoli , PA	pau
Paoli, PA	pau
Paradise, CA	cau
Paraguay, Argentina	ag#
Paramus, NJ	nju
Paris	fr#
(Paris	fr#
Paris and Bruges	fr#
(Paris and Dakar)	fr#
Paris and La Haye	fr#
Paris and Ottawa	fr#
(Paris-Algiers)	fr#
Paris-Sud	fr#
Paris, Grenoble	fr#
(Paris, Institut Franc^cais de Navigation)	fr#
Paris; Bruxelles	fr#
[Paris?]	fr#
(Paris)	fr#
[Paris]	fr#
Parish	xx#
Park Ridge, Ill.	ilu
Parkville	vra
Parkville, Vic	vra
Parkville, Vic.	vra
Parkville, Victoria	vra
Parliamentary Debates (Hansard)	enk
Parma	it#
Pasaden, CA	cau
Pasadena	cau
Pasadena, CA	cau
Pasadena, California	cau
Paterson, NJ	nju
Patricia Bay, Sidney, BC	bcc
Patterson, NJ	nju
Pau	fr#
(Pavia)	it#
Pechora	ru#
(Peekskill, NY)	nyu
Peking	cc#
Penang	my#
Penarth	wlk
Pender Island, BC	bcc
Penkhull, Stoke-on-Trent	enk
Penn	pau
Pennsylvania	pau
Pennsylvania, PA	pau
Pensacola, FL	flu
Pensacola, FL.	flu
Penticton, BC	bcc
Perm'	ru#
Perpignan	fr#
Perth	wea
Perth, Australia	wea
(Perth)	wea
Pesth	hu#
Petaluma, CA	cau
Peterborough	enk
Peterborough, Canada	onc
Peterborough, ON	onc
Peterborough, Ont.	onc
[Peterborough, Ont.]	onc
Peterborough, Ontario	onc
Peterhead	stk
(Peterhead)	stk
Peterlee	enk
Petoria	sa#
Petrazavodsk	ru#
Petrograd	ru#
(Petrograd)	ru#
Petropavlovsk-Kamchatksiy	ru#
Petropavlovsk-Kamchatskii	ru#
Petropavlovsk-Kamchatskiy	ru#
[Petropavlovsk-Kamchatskiy]	ru#
Petropavlovskiy-Kamchatskiy	ru#
Petropoli [St Petersburg]	ru#
Petroskoi	ru#
Petroskoy	ru#
Petrozavodsk	ru#
Petrozavodsk-Kamchatskiy	ru#
[Petrozavodsk]	ru#
Petrozavodski	ru#
Pfaffenweiler, Germany	gw#
Phaha	xx#
Philadelphia	pau
Philadelphia and London	pau
Philadelphia and New York	pau
Philadelphia, PA	pau
Philadelphia, Pa.	pau
[Philadelphia, PA]	pau
Philadelphia, Pennsylvania	pau
Philadelphia, USA	pau
[Philadelphia?]	pau
(Philadelphia)	pau
[Philadelphia]	pau
Philadephia	pau
Philadephia, PA	pau
Philadephia, Pennsylvania	pau
Philadeplphia, PA	pau
Phoenix Mill, Gloucestershire	enk
[Phoenix, AZ]	azu
Pieksa^uma^uki, Finland	fi#
Pilersuiffik	gl#
Pilersuiffik, Greenland	gl#
Pisa	it#
(Pisa)	it#
Piscataway, N.J.	nju
Piscataway, New Jersey	nju
Piscataway, NJ	nju
Pitcairn Press	xx#
Pitea^o, Sweden	sw#
Pithiviers	fr#
Pittsburg	pau
Pittsburgh	pau
Pittsburgh PA	pau
Pittsburgh, PA	pau
Pittsburgh, PN	pau
(Pittsburgh)	pau
[Pittsburgh]	pau
Plaistow	enk
Plaistow and Sutton Coldfield, England	enk
Plaistow, England	enk
Plancoe^ut, France	fr#
Planegg, Germany	gw#
(Pleasantville and New York)	nyu
Plouzane^a	fr#
Plouzane^a, France	fr#
Plymouth	enk
Plymouth, England	enk
[Plymouth]	enk
PO Box 210961, Auke Bay, AK 99821, USA	aku
PO Box 220, N-9520 Kautokeino, Norway	no#
PO Box 8100 Dep., N-0032 Oslo	no#
Point Cook, Australia	xx#
Point Hope, AK	aku
Poitiers, France	fr#
Pola	xx#
Poland	pl#
Polar Research Institute of China	cc#
Pomeroy, WA	wau
Pond Inlet, NWT	ntc
Poole	enk
Poole (England)	enk
Poole, England	enk
Poona	ii#
Porsgrunn, Norway	no#
Port Alsworth, AK	aku
[Port Alsworth, AK]	aku
Port Clyde, ME	meu
[Port Colbourne, Ont.]	onc
Port Hueneme, CA	cau
Port Hueneme, California	cau
Port Melbourne, VIC	vra
Port Moody, British Columbia	bcc
Port Stanley	fk#
Port Stanley, Falkland Islands	fk#
[Port Stanley]	fk#
Port Townsend, WA	wau
Portet-su-Garonne	fr#
Porthmadog	wlk
Portland	oru
Portland, OR	oru
Portland, Or.	oru
Portland, Oregon	oru
(Portland)	oru
[Portland]	oru
Porto Alegre	bl#
Portsea	enk
Portsmouth	enk
Portsmouth, England	enk
Portugal Cove	nfc
Porvoo	fi#
Porvoo, Finland	fi#
[Porvoo, Finland]	fi#
Porvoo, Helsinki	fi#
(Porvoo)	fi#
Post Mills, VT	vtu
Potsdam	gw#
Potsdam, Germany	gw#
[Potsdam]	gw#
Potters Bar	enk
Potters Bar, Herts.	enk
Potterville, MI	miu
Potts Point, NSW	xna
Poulsbo, WA	wau
Povungnituk, QC	quc
Pozan	pl#
Poznan	pl#
Poznan^a	pl#
Poznan^a, Poland	pl#
Prag	xr#
Prague	xr#
(Prague)	xr#
(Prague),	xr#
[Prague]	xr#
Praha	xr#
(Praha)	xr#
[Praha]	xr#
Prescott, Ontario	onc
Preston	enk
Preston, England	enk
Pretoria	sa#
Pretoria, South Africa	sa#
(Pretoria, Weather Bureau)	sa#
(Pretoria)	sa#
[Pretoria]	sa#
Prince Albert, Sask.	snc
Prince Albert, Saskatchewan	snc
Prince George, BC	bcc
Princeton	nju
Princeton NJ	nju
Princeton University Press	nju
Princeton, N.J.	nju
Princeton, New Jersey	nju
Princeton, NJ	nju
Princeton, NY	nyu
[Princeton]	nju
Princetown, NJ	nju
Privately printed	xx#
Prospect Heights, IL	ilu
Providence	riu
Providence, RI	riu
[Providence, RI]	riu
Provideniya	ru#
Provo, UT	utu
pu Izdatel'stvo Akademii Nauk SSSR	ru#
(Publishing House of the Central Committee of the Komsomol "Molodaya Gvardiya")	ru#
Puerto Madryn	ag#
Puerto Madryn, Argentina	ag#
Puerto Vallarta	mx#
Pueyrredo^an	ag#
Pukekohe, New Zealand	nz#
Pullman, WA	wau
Pullman, WA, USA	wau
Punta Arenas	cl#
Punta Arenas, Chile	cl#
Punta del Este, Uruguay	uy#
Punto Arenas	cl#
Punto Arenas, Chile	cl#
(Purford, Oxfordshire)	enk
Purto Madryn, Argentina	ag#
Pusan	ko#
Puschino	ru#
Pushchino	ru#
Putnam Valley, NY	nyu
Putney	enk
Puurs, Belgium	be#
Pymble, New South Wales	xna
[Qeqertarsuaq]	dk#
Qu^abec	quc
Quarto d'Altino, Italy	it#
Que^abec	quc
Que^abec, Canada	quc
Que^abec, Que	quc
Que^abec, Que.	quc
(Que^abec)	quc
[Que^abec]	quc
Quebec	quc
Quebec City	quc
Quebec, Canada	quc
Quebec, Que	quc
(Quebec)	quc
[Quebec]	quc
Queensland	qea
Quesnel, British Columbia	bcc
Quesnil British Columbia	bcc
Quincy, IL	ilu
Racine, WI	wiu
Racine, Wisconsin	wiu
Radebeul	gw#
Radebeul and Berlin	gw#
Radio I Svyaz'	ru#
Raleigh, NC	ncu
[Raleigh, NC]	ncu
Ralston, Alberta	abc
Ramsbury	enk
Randwick, NSW	xna
Rankin Inlet, N.W.T.	ntc
Rankin Inlet, NWT	ntc
(Ranum Statsseminarium, Denmark)	dk#
Ranum, Denmark	dk#
Raykjavi^ak	ic#
Raymond Terrace, NSW	xna
(Re^aykjavi^ak)	ic#
Reading	enk
Reading, Australia	at#
Reading, England	enk
Reading, MA	mau
Reading, PA	pau
[Reading]	enk
Red Deer, Alta	abc
Red Deer, Alta.	abc
Redmond, WA	wau
Reedsport, OR	oru
Regensburg	gw#
Regina	snc
Regina, Sask	snc
Regina, Sask.	snc
Regina, Saskatchewan	snc
Regina, Saskatchewan, Canada	snc
(Rego Park and New York)	nyu
Reinbeck bei Hamburg, Germany	gw#
Reinbek, Germany	gw#
Reine i Lofoten, Norway	no#
Remagen	gw#
Remagen, Germany	gw#
Rendsburg	gw#
Rengsdorg u^uber Neuwied	gw#
Renne	fr#
Rennes	fr#
Rennes, France	fr#
(Rennes)	fr#
Reno	nvu
Reno, NE	nvu
Reno, NV	nvu
[Reno]	nvu
Republica de Chile	cl#
[Resolute Bay, NWT?]	ntc
Resolute, NWT	ntc
Reston	vau
Reston, VA	vau
Reston, VA.	vau
[Reston, Va.]	vau
[Reston, VA]	vau
Reston, Virginia	vau
Reston,Virginia	vau
Reutlingen	gw#
Revelstoke	bcc
Revelstoke, BC	bcc
Reyjavik	ic#
Reyjkavi^ak	ic#
[Reykajavi^ak]	ic#
Reykjavi^ak	ic#
[Reykjavi^ak]	ic#
Reykjavik	ic#
Reykjavik, Iceland	ic#
(Reykjavik)	ic#
[Reykjavik]	ic#
Rhodos, Copenhagen	gr#
Ribe	dk#
Richardson, Texas	txu
Richland, WA	wau
Richmond	onc
Richmond Hill, Ont	onc
Richmond Hill, Ontario	onc
Richmond-on-Thames	enk
Richmond, Surrey	enk
Richmond, Victoria	vra
Rickmansworth	enk
Riga	lv#
(Riga)	lv#
Rijswijk	ne#
Rijswijk, Netherlands	ne#
(Rimini)	it#
Ringkjo^zbing	dk#
Ringkjo^zbing, Denmark	dk#
Ringkjo^zping	dk#
Ringsted, Denmark	dk#
Ringwood, VIC	vra
Rio de Janeiro	bl#
Rio de Janeiro, Brazil	bl#
(Rio de Janeiro)	bl#
Rio de Janerio	bl#
Rio Grande	ag#
[Rio Grande, Argentina]	ag#
Riso^u	dk#
Riso^z, Roskilde, Denmark	dk#
Riverside, CA	cau
Ro^zdovre, Denmark	dk#
Ro^zrvik	no#
Roanoke, VA	vau
Robertsbridge, E. Sussex, England	enk
Rochester	enk
Rochester, New York	nyu
Rochester, NY	nyu
Rock Island, IL	ilu
Rockland, ME	meu
Rockville, MD	mdu
Roitzsch	gw#
Roma	it#
(Roma)	it#
[Roma]	it#
Rome	it#
Rome, Italy	it#
(Rome)	it#
[Rome]	it#
Rosario	ag#
Rosario, Argentina	ag#
(Rosario)	ag#
Rosedale	nz#
Rosedale, New Zealand	nz#
Roskild, Denmark	dk#
Roskilde	dk#
Roskilde, Denmark	dk#
[Roskilde]	dk#
Ross Island, Antarctica	ay#
Ross-on-Wye	enk
Rossiya	ru#
Rostock	gw#
Rostov-na-Donu	gw#
Rostov-na-Dony	gw#
Rosvik, Sweden	sw#
Rotherburgerstrasse 12, 01099 Dresden	gw#
Rotherfield, E. Sussex	enk
Rotherham	enk
Rothersthorpe	enk
Rotterdam	ne#
Rotterdam, Brookfield	ne#
Rotterdam, Holland	ne#
Rotterdam, Netherlands	ne#
Rotterdam, The Netherlands	ne#
(Rotterdam)	ne#
[Rotterdam]	ne#
Rotterdam/Brookfield	ne#
Rouen	fr#
(Rouen)	fr#
Routell, France	fr#
Rovakatu, Finland	fi#
Rovaniemi	fi#
Rovaniemi, Finland	fi#
[Rovaniemi, Finland]	fi#
(Rovaniemi)	fi#
[Rovaniemi]	fi#
Rowville, Australia	vra
Royston	enk
Royston, England	enk
Rozzano	it#
[Rugby]	enk
Ruggell, Lichtenstein	lh#
[Runcorn]	enk
Rungsted Kyst	enk
Ruschlikon-Zurich	sz#
Russia	ru#
Rutgers, NJ	nju
Rutland	enk
Rutland, VT	vtu
Rutland, VT and Tokyo	vtu
Ryazan'	ru#
Ryl'sk	ru#
's Gravenhage, Netherlands	ne#
S-Gravenhage	ne#
'S-Gravenhage	ne#
's-Gravenhage, Netherlands	ne#
S-Peterburg	ru#
S. Peterburg	ru#
S.-Peterburg	ru#
S.-Peterburg'	ru#
S.-Petersburg	ru#
Sa^to Carlos	bl#
Sa^to Jose^a dos Campos, Brazil	bl#
Sa^to Paulo	bl#
Sa^to Paulo, Brasil	bl#
Sa^to Paulo, Brazil	bl#
Sa^ua^ubrucken	gw#
Sa^ua^urbrucken	gw#
Saabru^ucken	gw#
Saanichton	bcc
Saanichton-Seattle	bcc
Saanichton, B.C.	bcc
Saarbru^ucken	gw#
Saarbru^uken	gw#
Saarbrucken	gw#
Saarijarvi	fi#
Saertryk	dk#
[Saffron Walden]	enk
Sagamore Beach, MA	mau
Saint Cloud, France	fr#
Saint Paul University	onc
Saint Paul, Minnesota	mnu
Saint Paul, MN	mnu
Saint Petersburg	ru#
Saint-Boniface, Man.	mbc
Saint-Briac-sur-mer, France	fr#
Saint-Denis	fr#
Saint-E^atienne, France	fr#
Saint-Gilles, France	fr#
Saint-Jacques-de-la-Lande, France	fr#
Saint-Je^aro^hme, Marseille	fr#
Saint-Lambert, Quebec	quc
Saint-Malo	fr#
Saint-Malo, France	fr#
Saint-Martin d'Heres	fr#
Saint-Maur-des-Fosse^as, France	fr#
Saint-Nicholas, Que	quc
Saint-Paul, la Re^aunion	fr#
Saint-Petersburg	ru#
Saint-Petersburg, Russia	ru#
Saint-Pierre, la Re^aunion	fr#
Saint-Pierre, Re^aunion	fr#
Saint-Quentin	fr#
Sainte-Foy	quc
Sainte-Foy, Que	quc
Sainte-Foy, Que^abec	quc
Sainte-Foy, Quebec	quc
Sakhalinsk	ru#
Salamanca	sp#
Salcombe	enk
Salekhard	ru#
Salekhard-Yekaterinburg	ru#
[Salekhard, Russia]	ru#
Salem, MA	mau
Salford	enk
Salisbury	enk
Salisbury, Rhodesia	rh#
Sallanches	fr#
Salt Lake City	utu
Salt Lake City, UT	utu
[Salt Lake City, UT]	utu
Salt Spring Island, BC	bcc
Salzburg	au#
Salzburg, Austria	au#
[Salzburg]	au#
San Antonio, TX	txu
San Bernadino, CA	cau
San Bernardino, CA	cau
San Carlos de Bariloche	ag#
San Carlos de Bariloche, Argentina	ag#
San Carlos, CA	cau
San Diego	cau
(San Diego Zoological Magazine)	cau
San Diego, CA	cau
[San Diego, CA]	cau
San Diego, California	cau
San Diego, etc.	cau
San Diego, PA	cau
(San Diego)	cau
San Domenico, Italy	it#
San Francisco	cau
San Francisco, CA	cau
[San Francisco, CA]	cau
San Francisco, California	cau
(San Francisco)	cau
San Jose^a	cau
[San Jose^a, CA]	cau
San Jose, CA	cau
(San Juan-Mendoza-San Luis)	ag#
San Luis Ibispo, CA	cau
San Marino	cau
San Marino, CA	cau
San Mateo, CA	cau
San Miguel de Tucuma^an	ag#
San Rafael, CA	cau
San Sebastia^an	sp#
Sanata Barbara, CA	cau
Sandby (Sweden)	sw#
Sandefjord	no#
Sandefjord, Norway	no#
[Sandefjord]	no#
Sandefjorde	no#
Sandhurst	enk
Sandnes	no#
Sandwick, Shetland	uik
Sandy	enk
Sandy Bay	tma
Sandy Bay, TAS	tma
Sandy Bay, Tas ; Taroona, Tas	tma
Sandy Hook, CT	ctu
Sank Peterburg	ru#
Sankt Peterburg	ru#
Sankt Petersburg	ru#
Sankt-Peterburg	ru#
Sankt-Peterburk	ru#
Sankt-Petersburg	ru#
SanktPeterburg	ru#
Sanktpeterburg'	ru#
Sant-Peterburg	ru#
Santa Barbara, CA	cau
Santa Barbara, CAL	cau
Santa Barbara, California	cau
Santa Fe	nmu
Santa Fe, Argentina	ag#
Santa Fe, NM	nmu
(Santa Fe)	nmu
Santa Maria, Brazil	bl#
Santa Monica, CA	cau
[Santa Monica, CA]	cau
Santa Monica, California	cau
Sante Fe^a	nmu
(Santiaga)	cl#
Santiago	cl#
Santiago (Chile)	cl#
Santiago de Chile	cl#
(Santiago de Chile)	cl#
Santiago del Estero	ag#
Santiago, Chile	cl#
(Santiago)	cl#
[Santiago]	cl#
Sao Paulo	bl#
Sapporo	ja#
Sapporo, Japan	ja#
[Sapporo, Japan]	ja#
Saransk	ru#
Saransk, Mordovskaya SSR	ru#
Sarpsborg, Norway	no#
Sarreguemines, France	fr#
Sartov	ru#
Saskatchewan	snc
Saskatoon	snc
Saskatoon, Sakskatchewen	snc
Saskatoon, Sask	snc
Saskatoon, Sask.	snc
Saskatoon, Saskatchewan	snc
Saskatoon, Saskatchewan, Canada	snc
[Saskatoon]	snc
(Satiago)	cl#
Savoonga, AK	aku
Scarborough, ON	onc
Scarborough, Ont.	onc
Scarborough, Ontario	onc
Schenectady, NY	nyu
Scoresby, VIC	vra
Scoresbysund	gl#
Scotland	stk
Scott Polar Research Institute	enk
Seacaucus, NJ	nju
Seaford, Sussex	enk
Seattle	wau
Seattle and Anchorage	wau
Seattle and London	wau
Seattle WA	wau
Seattle, US	wau
Seattle, USA	wau
[Seattle, USA]	wau
Seattle, WA	wau
Seattle, WA, USA	wau
Seattle, WA.	wau
(Seattle, WA)	wau
[Seattle, WA]	wau
Seattle, Washington	wau
Seattle, Washington, USA	wau
[Seattle, Washington]	wau
(Seattle)	wau
[Seattle]	wau
Sebastopol	xx#
Secaucus, N.J.	nju
Selborne	enk
Selbourne	enk
Seldovia, AK	aku
Selent	gw#
Sendai	ja#
Seoul	ko#
[Seoul]	ko#
Sept-I^hles, Que^abec	quc
Settle, England	enk
Sevenoaks	enk
Sevenoaks, Kent	enk
Severo-Zapadnoye Knizhnoye Izdatel'stvo	ru#
Severodvinsk	ru#
Seville	sp#
Seville, Spain	sp#
(Seville)	sp#
Seward, AK	aku
Seyssinet-Pariset, France	fr#
Shadrinsk	ru#
Shanghai	cc#
Shanghai, China	cc#
(Shanghai)	cc#
Sharon, MA	mau
Sharon, Mass	mau
Sharon, Mass.	mau
Sharon, Massachusetts	mau
Sharon/MA	mau
Shawbury	enk
Sheffield	enk
(Sheffield)	enk
[Sheffield]	enk
Shelekhov	ru#
Shepperton	enk
Sherborne	enk
Sherbrooke	enk
ShiJaZhuang, Hebei Province	cc#
Shildon	enk
Shimizu, Shizuoka	ja#
Shimla	ii#
Shinkokai, Japan	ja#
Shrewsbury	enk
Shrewsbury, England	enk
Shrewsbury, UK	enk
(Shrewsbury)	enk
Shrivenham	enk
Sidney	bcc
Sidney, B.C.	bcc
Sidney, BC	bcc
Sidney, British Columbia	bcc
Siena	it#
Siena, Italy	it#
Sienna, Italy	it#
Sigmaringen, Germany	gw#
Sillery, Que	quc
Sillery, Quebec	quc
Silve Spring, MD	mdu
Silver Spring MD	mdu
Silver Spring, MD	mdu
[Silver Spring, MD]	mdu
Simferopol'	ru#
[Simla]	ii#
Simonstown	sa#
Singapore	si#
Sint-Martens-Latem, Belgium	be#
Sint-Martins-Latem (Deurle), Belgium	be#
Sisimiut	gl#
Sisimut, Greenland	gl#
Sister Bay, WI	wiu
Sitka	aku
Sitka, AK	aku
[Sitka, AK]	aku
Sitzungsber	gw#
[Ska^orer]	no#
[Skaerbaek]	dk#
Skagen, Denmark	dk#
Skagway, AK	aku
Skein, Norway	no#
Skelleftea^o	sw#
Skelleftea^o, Sweden	sw#
Skelleftehamn, Sweden	sw#
Ski, Norway	no#
Skien	no#
Skien, Norway	no#
Skive, Denmark	dk#
Skjern	dk#
[Skjern], Denmark	dk#
Skodsborg, Denmark	dk#
Skovlunde, Denmark	dk#
Slimbridge	enk
Slimbridge, England	enk
Slo^uinge, Sweden	sw#
Slough	enk
Slough, England	enk
Smarden	enk
Smarden, Kent	enk
Sna^osa, Norway	no#
Snakt Peterburg	ru#
Snohomish, WA	wau
So^zborg, Denmark	dk#
Socorro	nmu
Sodankyla^u, Finland	fi#
Sofia	bu#
Sofia, Bulgaria	bu#
(Sofia)	bu#
Sofiya	bu#
Sol'vychegodsk	ru#
Solheimsvik	no#
Solihull	enk
Solna	sw#
Solna, Sweden	sw#
Solo^zy, Norway	no#
Solomons, MD	mdu
Solovki	ru#
Somerset	enk
Somerton	enk
Somerville, MA	mau
Sommie^gres, France	fr#
Sophia	bu#
Sopot, Poland	pl#
Sortavala	ru#
Sosnowiec	pl#
Sosnowiec, Poland	pl#
Souix Falls, SD	sdu
South Africa	sa#
South Beloit, IL	ilu
South Boston, MA	mau
South Brunswick	nju
South Freemantle, WA	wau
South Georgia	xs#
South Hackensack, NJ	nju
South Holland, IL	ilu
South Korea	ko#
South Melbourne, Australia	vra
South Yarra, Australia	vra
South Yarra, Vic	vra
Southall	enk
Southampton	enk
Southampton[?]	enk
[Southampton]	enk
Southbank, Australia	vra
Southbank, VIC	vra
Southborough, Kent, England	enk
(Southborough, MA)	mau
[Southhampton]	enk
[Southland, New Zealand]	nz#
[Southport]	enk
Spain	sp#
Sparkford	enk
Sparkford, Somerset	enk
SPB	xx#
Spennymoor	enk
Spitsbergen	no#
Spitsbergen, Norway	no#
[Spitsbergen]	no#
Spokane	wau
Spokane, WA	wau
Springer	xx#
Springfield, IL	ilu
Springfield, Illinois	ilu
Springfield, VA	vau
Springfield, Virginia	vau
Springwood, NSW	xra
St Albans	enk
St Andrews	stk
[St Andrews, Scotland]	stk
[St Andrews]	stk
St Anthony Falls, MN	mnu
St Catharines, Ont.	onc
St John, NB	nbc
St John's	nfc
(St John's College, Cambridge)	enk
St John's, Newfoundland	nfc
[St John's, Newfoundland]	nfc
St John's, Nfld	nfc
St John's, Nfld.	nfc
St John's, Nwfld	nfc
St John's, Nwfld.	nfc
[St John's]	nfc
St Joseph, Michigan	miu
St Laurent, PQ	quc
St Leonards, NSW	xna
St Louis	mou
St Louis, MO	mou
St Paul	mnu
St Paul, Minnesota	mnu
St Paul, MN	mnu
St Pe^atersbourg	ru#
St Peterburg	ru#
St Petersberg	ru#
St Petersburg	ru#
(St Petersburg)	ru#
St Petersburg)	ru#
St-Denis de La Re^aunion, France	fr#
St-Paul, MN	mnu
St. Albans	enk
St. Andrews	stk
St. Andrews, NB	nbc
St. Andrews, New Brunswick	nbc
[St. Andrews]	stk
St. Catharines, ON	onc
St. Catharines, Ont.	onc
St. Helena	xj#
St. Ignatius, MT	mtu
St. Ives, Cambridgeshire	enk
St. John's	xx#
(St. John's College, Cambridge)	enk
St. John's Newfoundland	nfc
St. John's NL	nfc
St. John's, Newfoundland	nfc
[St. John's, Newfoundland]	nfc
St. John's, NF	nfc
St. John's, Nfld	nfc
St. John's, Nfld, Canada	nfc
St. John's, Nfld.	nfc
St. John's, NL	nfc
St. John's, Nwfld	nfc
St. Johns	nfc
St. Johns's, Newfoundland	nfc
St. Lawrence, KS	ksu
St. Leonards, Australia	xna
St. Leonards, NSW	xna
St. Louis	miu
St. Louis, MI	miu
St. Lucia	qea
St. Lucia, Queensland	qea
St. Paul, MN	mnu
St. Pe^atersbourg	ru#
St. Peterburg	ru#
(St. Petersbourg)	ru#
St. Petersburg	ru#
St. Petersburg and Leipzipg	ru#
St. Petersburg, Russia	ru#
(St. Petersburg)	ru#
[St. Petersburg]	ru#
St. Petersbury	ru#
St. Romain de Colbosc, France	fr#
St.-Peterburg	ru#
St.John's, Newfld	nfc
St.John's, Newfoundland	nfc
(St.John's)	nfc
St.Louis	mou
St.Paul, MN	mnu
St.Petersburg	ru#
Stamford, CT	ctu
Stamsund	no#
Stamsund, Norway	no#
Stanford	cau
Stanford University	cau
Stanford University Press	cau
Stanford, C.A.	cau
Stanford, CA	cau
Stanford, Ca.	cau
Stanford, California	cau
Stanfordville, NY	nyu
Stanley	fk#
Stanley, Falkland Islands	fk#
[Stanley, Falkland Islands]	fk#
[Stanley]	fk#
Stanmore	enk
Staplehurst	enk
State College, P.A.	pau
Statni nakladatelstvi politicke literatury	xr#
Staunton, VA	vau
Stavanger	no#
Stavanger, Norway	no#
[Stavanger?]	no#
Ste Anne-de-Bellevue, Quebec	quc
Ste-Anne-de-Bellevue, Que^abec	quc
Ste-Anne-de-Bellevue, Quebec	quc
Ste-Foy (Que^abec)	quc
Ste-Foy, Qc	quc
(Ste. Anne de Bellevue, P.Q.)	quc
Ste. Anne de Bellevue, Quebec	quc
Steinfurt	gw#
Steinfurt, Germany	gw#
Steinkjer, Norway	no#
(Steinkopf)	sa#
Stellenbosch	sa#
Stellenbosch, SA	sa#
Stellenbosch, South Africa	sa#
[Stellenbosch]	sa#
Sterling, VA	vau
Steszew, Poland	pl#
Steven Point, WI	wiu
Stevens Point	wiu
Stevens Point, WI	wiu
Stillwater, MN	mnu
Stillwater, MN USA	mnu
Stillwater, MN.	mnu
Stirling	enk
Stockhholm	sw#
Stockhold	sw#
Stockholm	sw#
Stockholm, Sweden	sw#
[Stockholm, Sweden]	sw#
Stockholm?	sw#
(Stockholm)	sw#
[Stockholm]	sw#
Stockkolm	sw#
Stockport	enk
Stockridge, MA	mau
Stocksfield, Northumberland	enk
Stoke Gabriel	enk
Stokmarknaes	no#
Stolpen	gw#
Stolpen, Germany	gw#
Stoneham, MA	mau
(Stonglandseidet)	no#
Stonington, CT	ctu
Stornoway	stk
[Storrs, CT]	ctu
Strand, UK	enk
Strasbourg	fr#
Strasbourg, France	fr#
[Strasbourg]	fr#
Strassburg	au#
(Strassburg)	au#
Strathaven, Lanarkshire	stk
Strawberry Hills, NSW	xna
Streatham	enk
Stromness	stk
Stromness, Scotland	stk
Stroud	enk
Stroud, England	enk
[Stroud]	enk
Stroudsberg	pau
Stroudsburg, PA	pau
Struckum, Germany	gw#
Stryn	no#
Sturminster Newton	enk
Stutgart	gw#
Stutgart, Germany	gw#
Stuttgard	gw#
Stuttgart	gw#
(Stuttgart and Leipzig)	gw#
(Stuttgart und Leipzig)	gw#
(Stuttgart-Leipzig)	gw#
Stuttgart, Germany	gw#
(Stuttgart)	gw#
Stuttgart/Tu^ubingen	gw#
Styktyvkar	ru#
Sudbury, ON	onc
Sudbury, Ont	onc
Suitland, MD	mdu
Sukkertoppen	gl#
Summerland, BC	bcc
Sun Valley, CA	cau
Sunderland	enk
Sundsvall, Sweden	sw#
Sunnyvale, CA	cau
Surbiton	enk
Suresnes, France	fr#
Surgut	ru#
Surrey	enk
Surrey, B.C.	bcc
Surrey, BC	bcc
Surrey, British Columbia	bcc
Surrey, England	enk
Surrey, UK	enk
Surry Hills, New South Wales	xna
Surry Hills, NSW	xna
Sussex	enk
Sutherland, New South Wales	xna
Sutton	enk
Sutton Coldfield	enk
(Sutton, Surrey)	enk
Svalbard	no#
Svalbard, Norway	no#
Svanhovd	no#
Svanhovd, Norway	no#
Svanvik	no#
Svanvik, Norway	no#
Svartskog	no#
Sverdlovsk	ru#
[Svolvaer]	no#
Svorkmo, Norway	no#
Swallow Press	ilu
Swansea	wlk
Swansea, UK	wlk
[Swansea]	wlk
Sweden	sw#
[Sweden]	sw#
Swindon	enk
Swindon, England	enk
Swindon, UK	enk
[Swindon]	enk
Switzerland	sz#
(Switzerland)	sz#
[Switzerland]	sz#
Sydney	xna
Sydney, Australia	xna
[Sydney, Australia]	xna
Sydney, BC	bcc
Sydney, London and Melbourne	xna
Sydney, NSW	xna
(Sydney, NSW)	xna
[Sydney, NSW]	xna
(Sydney)	xna
[Sydney]	xna
Sydpro^zven	gl#
Sydpro^zven, Greenland	gl#
Syktyvar	ru#
Syktyvkar	ru#
Syktyvkar 1995	ru#
Syktyvkar-Kirov	ru#
[Syktyvkar]	ru#
Syktyvkvar	ru#
Syosset, NY	nyu
Syracuse, New York	nyu
Syracuse, NY	nyu
[Syracuse, NY]	nyu
Sywell	enk
SZ Lisse, Netherlands	ne#
Szombathely	hu#
[t.b.c.]	xx#
Ta^unna^us, Sweden	sw#
Ta^urnaby, Sweden	sw#
Tacoma, WA	wau
Tacoma, Washington	wau
Tadworth, Surrey	enk
Taichung, Taiwan	ch#
Takeley	enk
Takely	enk
Talkeetna, AK	aku
Tallahassee	flu
Tallahassee, FL	flu
Tallahassee, FL.	flu
Tallahassee, Florida	flu
Tallahassee, USA	flu
Tallin	er#
Tallinn	er#
Tallinn-Ka^usmu, Estonia	er#
Tallinn, Estonia	er#
[Tallinn]	er#
Tampa, FL	flu
Tampere	fi#
Tampere, Finland	fi#
[Tampere, Finland?]	fi#
Tampere?, Finland	fi#
[Tampere]	fi#
Tananarive	mg#
(Tananarive, Malagasy Republic)	mg#
(Tananarive)	mg#
[Tananarive]	mg#
Tantanarive, Madagascar	mg#
Tapiola, Finland	fi#
Tartu	er#
Tartu, Estonia	er#
[Tartu]	er#
Tashkent	uz#
Tasiilaq	dk#
Tasmania	tma
Tasmania, TA	tma
[Tasmania]	tma
Tasmanian	tma
Taunton	enk
Taunton, MA	mau
Taunton, MD	mdu
Taunton, UK	enk
Tavistock	enk
[tbc]	xx#
Tbilisi	gs#
Te Delft	ne#
Te Haarlem	ne#
Te Middelburg	ne#
[Teddington]	enk
Tel-Aviv	is#
Temecula, CA	cau
Tempe	azu
Tempe, AZ	azu
[Terijoki]	ru#
Terrey Hills, NSW	xna
Terry Hills, NSW	xna
Terschelling, The Netherlands	ne#
Texas	txu
Texel, Netherlands	ne#
Thatcham	enk
[The Hague]	ne#
Theil (Wien)	au#
Thetford Center, VT	vtu
Thomasville, GA	gau
Thornhill, Dumfriesshire	stk
Thornhill, Ont.	onc
Thornhill, Ontario	onc
Three Hills, Alberta	abc
Thule Air Base, Greenland	gl#
Thunder Bay	onc
Thunder Bay, Canada	onc
Thunder Bay, Ont.	onc
[Thunder Bay, Ont.]	onc
Thunder Bay, Ontario	onc
Tianjin, China	cc#
Tielt, Belgium	be#
Tientsin	cc#
(Tiflis)	gs#
Tiguri	sz#
Tiverton	enk
To^arshavn	fa#
To^arshavn, Faroes	fa#
[To^arshavn]	fa#
To^unning	gw#
To^znsberg	no#
To^znsberg, Norway	no#
Tobol'sk	ru#
Tobol'sk-Omsk	ru#
Tobolsk	ru#
Tohoku	ja#
Tok, AK	aku
Tokyo	ja#
Tokyo, Japan	ja#
[Tokyo?]	ja#
(Tokyo)	ja#
[Tokyo]	ja#
Tolworth, UK	enk
(Tomo)	xx#
Tomsk	ru#
Tonbridge, Kent	enk
Tonsberg, Norway	no#
Topsfield, MA	mau
Torino	it#
Torino, Italy	it#
(Torino)	it#
[Torino]	it#
Tornio, Finland	fi#
Toronto	onc
Toronto (Montreal)	onc
Toronto and Buffalo	onc
Toronto and Montreal	onc
Toronto and Vancouver	onc
Toronto Clarke	onc
Toronto, Canada	onc
Toronto, ON	onc
Toronto, ON, Canada	onc
Toronto, ONT	onc
Toronto, Ont.	onc
[Toronto, Ont.]	onc
[Toronto, Ont]	onc
Toronto, Ontario	onc
Toronto?	onc
(Toronto)	onc
[Toronto]	onc
Toronto/Thunder Bay/Timmins	onc
Toru^an	po#
Torun	po#
Torun^a	po#
Torun^a, Poland	po#
Torun, Poland	po#
Totnes, England	enk
Totowa, N.J.	nju
Totowa, NJ	nju
Toulon	fr#
Toulouse	fr#
Toulouse, France	fr#
Tournai, Belgium	be#
Tours	fr#
Tours, France	fr#
(Tours)	fr#
[Tours]	fr#
Towcester	enk
Toyama	ja#
Toyama, Japan	ja#
Toyko	ja#
Tra^uslo^uvsla^uge, Sweden	sw#
Traben-Trarbach	gw#
Tralee	ie#
Trier	gw#
Trieste	it#
Trieste, Italy	it#
Tring	enk
(Tring)	enk
Tristan da Cunha	xj#
Trivandrum	ii#
Tro^zmso^z	no#
Tro^zmso, Norway	no#
Tromso	no#
Tromso^z	no#
Tromso^z Museum	no#
Tromso^z-Oslo-Bergen	no#
Tromso^z, Norway	no#
[Tromso^z, Norway?]	no#
Tromso^z, Oslo, Bergen	no#
[Tromso^z]	no#
[Tromso^z], Norway	no#
Tromso-Oslo-Bergen	no#
Tromso, Norway	no#
[Tromso]	no#
Trondheim	no#
Trondheim, etc.	no#
Trondheim, Norway	no#
[Trondheim, Norway]	no#
[Trondheim]	no#
[Trondheim], Norway	no#
Trondhjem	no#
(Trowbridge)	enk
Trumso	no#
Truro	enk
(Truro)	enk
Tsiigehtchic, NT	nuc
Tsligehtchic, NT	nuc
Tu^ubingen	gw#
Tu^ubingen, Germany	gw#
(Tu^ubingen)	gw#
Tualatin, OR	oru
(Tubingen)	gw#
Tucson	azu
Tucson, AZ	azu
[Tucson, AZ]	azu
Tucson, USA	azu
Tucuma^an	ag#
Tucuma^an, Argentina	ag#
(Tucuma^an)	ag#
Tucuman	ag#
Tula	ru#
(Tula)	ru#
Tulsa	oku
Tulsa, OK	oku
Tulsa, Oklahoma	oku
Tunbridge Wells	enk
[Tunbridge Wells]	enk
Turangi, New Zealand	nz#
Turin	it#
(Turin)	it#
Turku	fi#
Turku, Finland	fi#
[Turku]	fi#
[Turku], Finland	fi#
Turnhout, Belgium	be#
[Tusaayaksat, NWT]	xna
Tuscaloosa, AL	alu
Tuscon	azu
Tuscon, AZ	azu
Tuva	ru#
Tver'	ru#
Twentynine Palms, California	cau
Twickenham	enk
Twin Cities	mnu
Tylers Green	enk
Tylers Green, Bucks	enk
Tyumen	ru#
Tyumen'	ru#
Tyumens	ru#
U.K.	enk
U.S. Fish and Wildlife Service	xxu
U.S.A.	xxu
Uccle	be#
Uccle-Bruxelles	be#
(Uccle-Bruxelles)	be#
Uccle, Belgium	be#
Uddevalla	sw#
Ufa	ru#
Ufa-Tomsk	ru#
Uhrichsville, OH	ohu
UK	xxk
Ukhta	ru#
Ulaan-Ude	ru#
Ulaanbaatar, Mongolia	cc#
Ulad-Ude	ru#
[Ulan Bator?]	cc#
Ulan Ude	ru#
Ulan-Ude	ru#
Ulfborg, Denmark	dk#
Ulm	gw#
Ulm-Donau, Germany	gw#
Ulsteinvik	no#
Ulverston	enk
Umanak	gl#
Umanak, Greenland	gl#
Umea	sw#
Umea^o	sw#
Umea^o, Sweden	sw#
[Umea^o, Sweden]	sw#
(Umea^o)	sw#
[Umea^o]	sw#
Unanderra	xna
Unanderra, NSW	xna
Unesco House	fr#
Unionville, IL	ilu
Unionville, NY	nyu
Unit 8, 14 Lonsdale Street, Braddon, ACT	aca
United Kingdom	xxk
[United Kingdom]	xxk
United States. Department of the Interior	xxu
United States. Department of Transportation	xxu
[United States]	xxu
Universal City, CAL	cau
Universidad de Magallanes	cl#
Universita^utsverlag Wagner	au#
(Universite^a P.M. Curie, Paris)	fr#
(University of Aberdeen. Centre for Defence Studies)	stk
(University of Alaska Fairbanks)	aku
University of British Columbia	bcc
University of Cape Town	sa#
(University of Nebraska, College of Engineering and Technology)	nbu
(University of North Carolina)	ncu
(University of Tsukuba)	ja#
[University of Wyoming]	wyu
University Park, PA	pau
[University Park, PA]	pau
[University Park, PN]	pau
University Park, PN	oay
Unpublished	xx#
Upper Saddle River, NJ	nju
[Upperville, VA]	vau
Uppsala	sw#
(Uppsala and Stockholm)	sw#
Uppsala Universitet	sw#
Uppsala, Sweden	sw#
(Uppsala)	sw#
[Uppsala]	sw#
Upsala	sw#
Upsala, Sweden	sw#
Upton upon Severn, Worcs, UK	enk
Urbana and Chicago	ilu
Urbana-Champaign, IL	ilu
Urbana, IL	ilu
US	xxu
USA	xxu
USA?	xxu
(USA)	xxu
[USA]	xxu
Ushuaia	ag#
Ushuaia, Argentina	ag#
[Ushuaia, Argentina]	ag#
Usinsk	ru#
Usk	wlk
USSR	ru#
Ust'-Omchug	ru#
Ust'-Tsil'ma	ru#
Usti^a nad Orlici^a, Czech Republic	xr#
Utrecht	ne#
Utrecht and Antwerpen	ne#
Utrecht, Netherlands	ne#
Utrecht, NL	ne#
Utrecht, The Netherlands	ne#
(Utrecht)	ne#
[Utrecht]	ne#
Utsjoki, Finland	fi#
Uttoxeter	enk
[Uummannaq, Greenland]	gl#
Uxbridge	enk
VA	vau
Va^ustera^os	sw#
Va^usteras	sw#
Va^ustervik, Sweden	sw#
Vaasa, Finland	fi#
Vadso^z	no#
Vadso^z, Norway	no#
[Vadso^z]	no#
Vaduz	lh#
Vaduz, Liechenstein	lh#
Vaduz, Liechtenstein	lh#
Valatie, NY	nyu
Valdez, AK	aku
Valence	fr#
Valencia	sp#
Valenciennes-Cedex, France	fr#
Valladolid	sp#
Valladolid, Spain	sp#
Valparai^aso, Chile	cl#
Valparaiso	cl#
Valparaiso, Chile	cl#
(Valparaiso)	cl#
[Valparaiso]	cl#
Vammala, Finland	fi#
Vancouver	bcc
Vancouver, B.C.	bcc
Vancouver, BC	bcc
Vancouver, BC, Canada	bcc
[Vancouver, BC]	bcc
Vancouver, British Columbia	bcc
Vancouver, Canada	bcc
Vancouver, Washington	wau
[Vancouver]	bcc
Vancouver/Toronto	bcc
Vanier, Ontario	onc
Vantaa, Finland	fi#
Varanger, Norway	no#
Vardo^z	no#
Various	xx#
Varnamo, Sweden	sw#
Varshava	pl#
Varsovie, Poland	pl#
(Varsovie)	pl#
Vasco-da-Gama, Goa	ii#
Vasco-da-Gama, India	ii#
Vaughan, Ont.	onc
Vedbaek	dk#
[Vedbaek]	dk#
Vejen, Denmark	dk#
Velikiy Novgorod	ru#
Vendo^ume	fr#
Veneto	it#
Venezia	it#
[Venezia]	it#
Venice	it#
Venice, Italy	it#
[Venice]	it#
Verbania-Intra	it#
Vercelli	it#
Verkhneudinsk	ru#
Vero Beach, FL	flu
Verona	it#
Verona, VA	vau
Versailles	fr#
Vestera^os, Sweden	sw#
Vestfossen	no#
Viale Trento, Fermo	it#
Viborg, Denmark	dk#
Vic^cosa, Brazil	bl#
Vicariat de La Baie d'Hudson	xxc
Vicksburg, MS	msu
Vicksburg, MS, USA	msu
Victoria	vra
Victoria, Aus.	vra
Victoria, B.C.	bcc
Victoria, BC	bcc
Victoria, BC, Canada	bcc
[Victoria, BC]	bcc
Victoria, British Columbia	bcc
Vidlin, Shetland	uik
Vienna	au#
Vienna / Munich, Germany	au#
Vienna, Austria	au#
(Vienna)	au#
[Vienna]	au#
Vigna di Valle, Roma	it#
Vigo, Spain	sp#
[Vigo]	sp#
Vil'nyus	li#
Vilhelmina	sw#
Vilhelmina, Sweden	sw#
Ville La Salle, Que^a	quc
Ville St-Laurent, QC	quc
Villigen, Switzerland	sz#
Villingen	sz#
Vilnius	li#
Vinterbro, Norway	no#
Virginia	vau
Virginia Beach, VA	vau
Virum, Denmark	dk#
Viterbo	it#
Vlad	ru#
Vladikavkaz	ru#
Vladimir	ru#
(Vladivostock)	ru#
Vladivostok	ru#
(Vladivostok)	ru#
Vladivstok	ru#
Vlissingen	ne#
Vlissingen, Netherlands	ne#
Vodbaek	no#
Vollebekk, Norway	no#
Vologda	ru#
Voronezh	ru#
Voroshilov	ru#
WA	wau
[Waco, TX]	txu
Wadebridge	enk
[Wageningen, Holland]	ne#
Wageningen, Netherlands	ne#
Waibstadt bei Heidelberg	gw#
Waikanae	nz#
Wakefield	enk
Wakeham, P.Q.	xx#
[Wako] Japan	ja#
Wales	wlk
Wallingford	enk
Wallingford, England	enk
Wallingford, Oxfordshire	enk
Wallingford, Oxon	enk
Wallingford, UK	enk
[Wallingford]	enk
Wallington	enk
Wallington, Surrey	enk
Walnut Creek, C	cau
Walnut Creek, CA	cau
Waltham, MA	mau
Ward, CO	cou
Ware	enk
Ware, Herts	enk
Warsaw	pl#
Warsaw, Poland	pl#
(Warsaw)	pl#
[Warsaw]	pl#
Warszawa	pl#
Warszawa and Krako^aw	pl#
Warszawa Zagospodarowania	pl#
(Warszawa)	pl#
Warwick	enk
Warzawa	pl#
Washdington, DC	dcu
Washington	xxu
Washington 25 D.C	dcu
Washington City [Washington, DC]	dcu
[Washington D. C.]	dcu
Washington D.C	dcu
Washington D.C.	dcu
[Washington D.C.]	dcu
Washington DC	dcu
Washington DC, USA	dcu
(Washington DC)	dcu
[Washington DC]	dcu
Washington,	xxu
Washington, CD	dcu
Washington, D.C.	dcu
(Washington, D.C. )	dcu
(Washington, D.C.)	dcu
[Washington, D.C.]	dcu
Washington, DC	dcu
Washington, DC and New York	dcu
Washington, DC, USA	dcu
Washington, DC.	dcu
(Washington, DC)	dcu
[Washington, DC]	dcu
Washington, USA	xxu
Washington,DC	dcu
Washington.	xxu
(Washington)	xxu
[Washington]	xxu
Washinton	xxu
Washougal, WA	wau
Wasilla	aku
Wasilla, AK	aku
Wasseralfingen, Germany	gw#
[Waterbury, CT]	ctu
Waterhouses, Staffordshire	enk
Waterloo	onc
Waterloo, ON	onc
Waterloo, Ont	onc
Waterloo, Ont.	onc
(Waterloo, Ont.)	onc
Waterloo, Ontario	onc
[Waterloo]	onc
Waterlooville	enk
[Watford]	enk
Waveland	msu
Wawsaw	pl#
Weener	gw#
Weimar	gw#
(Weimar, Bertuch)	gw#
(Weimar)	gw#
[Weimar]	gw#
Wein	au#
(Wein)	au#
Weinheim	gw#
Weissfluhjoch-Davos	sz#
Weissfluhjoch, Davos	sz#
Weissfluhjoch/Davos	sz#
Wellingborough, Northants	enk
[Wellingborough, UK]	enk
[Wellingborough]	enk
Wellington	nz#
Wellington, Christchurch and Dunedin	nz#
Wellington, etc.	nz#
Wellington, N.Z.	nz#
(Wellington, N.Z.)	nz#
Wellington, New Zealand	nz#
Wellington, NZ	nz#
(Wellington, NZ)	nz#
[Wellington, NZ]	nz#
Wellington. New Zealand	nz#
(Wellington)	nz#
[Wellington]	nz#
Wels, Austria	au#
[Welwyn Garden City]	enk
Wendover	enk
Werbomont, Belgium	be#
Wessling	gw#
[West Baffin Island]	nuc
West Byfleet	enk
West Conshohocken, PA	pau
West Cork, Ireland	ie#
West Gosford, N.S.W.	xna
West Harting, England	enk
West Lafayette, Indiana, USA	inu
West Lakes, SA	sa#
West Long Branch, NJ	nju
West Palm Beach, FL	flu
West Perth	wea
West Perth, WA	wea
West Point, NY	nyu
West Vancouver	bcc
West Vancouver, B.C.	bcc
West Vancouver, BC	bcc
Westcliffe-on-Sea	enk
Westminster	enk
Westmont, Que.	quc
Westport and London	enk
Westport, Conn.	ctu
Westport, Connecticut	ctu
Westport, CT	ctu
Wetaskiwin, Alta	abc
Weybridge	enk
Weyburn, SK	snc
Weymouth, England	enk
[Whakatane]	nz#
Whale Cove, NWT	ntc
Whatamongo Bay, NZ	nz#
Wheeling, IL	ilu
Whitby	enk
Whitby, England	enk
Whitby, U.K.	enk
[Whitby, Yorkshire]	enk
White River Junction, VT	vtu
Whitefish, MT	mtu
Whitehaven, Cumberland	enk
Whitehorse	ykc
Whitehorse and Calgary	ykc
Whitehorse, Canada	ykc
Whitehorse, YK	ykc
Whitehorse, YT	ykc
[Whitehorse, YT]	ykc
Whitehorse, Yukon	ykc
Whitehorse, Yukon Territory	ykc
[Whitehorse, Yukon]	ykc
[Whitehorse?]	ykc
[Whitehorse]	ykc
Whittier, CA	cau
Wien	au#
Wien and Leipzig	au#
Wien-Innsbruck-Mu^unchen	au#
(Wien-Leipzig)	au#
Wien, Austria	au#
(Wien)	au#
[Wien]	au#
Wiesbaden	gw#
Wiesbaden, Germany	gw#
(Wiesbaden)	gw#
Wildwood, New Jersey	nju
Wilkes Station, Antarctica	ay#
Williamsburg, VA	vau
Williston, Vermont	vtu
Williston, VT	vtu
Willow, AK	aku
Willowdale, ON	onc
Willowdale, ONT	onc
Willowdale, Ont.	onc
Wilmett, IL	ilu
Wilmette, IL	ilu
[Wilmette, IL]	ilu
Wilmington, Massachusetts	mau
Wilton, CT	ctu
Wilton, Eire	ie#
Wimborne, Dorset	enk
Winchester	enk
Windsor, New South Wales	xna
Windsor, Ont.	onc
[Windsor]	enk
Winipeg, Manitoba	mbc
Winlaw, BC	bcc
Winnipeg	mbc
Winnipeg MB, Canada	mbc
Winnipeg, Canada	mbc
Winnipeg, Man	mbc
Winnipeg, Man.	mbc
[Winnipeg, Man]	mbc
Winnipeg, Manitoba	mbc
[Winnipeg, Manitoba]	mbc
Winnipeg, MB	mbc
Winnipeg, MN	mbc
(Winnipeg)	mbc
[Winnipeg]	mbc
Winterthur, Switzerland	sz#
Wisconsin	wiu
Wisconsin-Madison	wiu
(Wisconsin)	wiu
Wittenberg	gw#
Wittenberg Lutherstadt	gw#
Wittenberg-Lutherstadt	gw#
Wittenburg Lutherstadt	gw#
Wl^zochy	pl#
Woden, ACT	aca
(Woking)	enk
Wokingham	enk
Wolcott	ctu
Wolcott, CT	ctu
Wolcott, VT	vtu
Wolfe Island, Ontario	onc
Wollongong, NSW	xna
Woodbridge	enk
Woodbridge, England	enk
Woodbridge, Ont	onc
Woodbridge, Suffolk	enk
Woodbridge, VA	vau
[Woodbury, CT]	ctu
Woodland Hills, California	cau
Woods Hole	mau
Woods Hole, MA	mau
Woods Hole, Massachusetts	mau
Woods Hole, USA	mau
Woolwich, London	enk
Woonona, NSW	xna
Worcester	enk
Worcester Park, Surrey	enk
Wormerveer, Netherlands	ne#
Wormley, England	enk
Wormley, Godalming	enk
Wormley, Surrey	enk
Worms	gw#
Worthington, OH	ohu
Wrocl^zaw	pl#
Wrocl^zaw, etc	pl#
Wrocl^zaw, Poland	pl#
(Wrocl^zaw)	pl#
Wroclzaw, Poland	pl#
Wu^urzburg	gw#
Wuhan, China	cc#
Wuppertal-Barmen	gw#
Wurzburg	gw#
Wushan, Guangzhou	cc#
WWW	xx#
[www, MediaTekk]	xx#
Wyk	pl#
Wyk/Fo^hr	pl#
Wyoming, USA	wyu
Yakaterinburg	ru#
Yakima, WA	wau
Yaksha, Komi	ru#
Yaktusk	ru#
Yakut	ru#
Yakutiya	ru#
Yakutks	ru#
Yakutsk	ru#
Yakutsk and Moscow	ru#
[Yakutsk?]	ru#
[Yakutsk]	ru#
Yakutskay	ru#
Yalding	enk
Yale	ctu
Yamagata-ken, Shinjo-shi, Tokamachi	ja#
Yamagata-shi	ja#
Yarmouth	enk
Yarmouthport, ME	meu
Yaroomba, QLD	qea
Yaroslavl'	ru#
Yarrow, BC	bcc
Yekaterinburg	ru#
Yekaterinburg-Salekhard	ru#
Yellowkife, NWT	ntc
[Yellowkife, NWT]	ntc
Yellowknife	ntc
Yellowknife N.W.T.	ntc
Yellowknife, Canada	ntc
Yellowknife, N.W.T.	ntc
Yellowknife, NT	ntc
[Yellowknife, NT]	ntc
Yellowknife, NWT	ntc
Yellowknife, NWT, Canada	ntc
Yellowknife, NWT.	ntc
[Yellowknife, NWT]	ntc
[[Yellowknife, NWT]	ntc
Yellowknife, YT	ntc
Yellowknife,NWT	ntc
[Yellowknife?]	ntc
[Yellowknife]	ntc
[Yellowknife], N.W.T.	ntc
Yellownife	ntc
Yelverton, Devon	enk
Yelverton, England	enk
Yerseke, The Netherlands	ne#
Yokohama	ja#
York	enk
York , England	enk
York, England	enk
York, PA	pau
Yoshkar - Ola	ru#
Yoshkar-Ola	ru#
Yukon	ykc
Yuzhno-Sakhalinsk	ru#
(Zagreb)	ci#
Zaltbommel, Netherlands	ne#
Zaragoza	sp#
Zaural'ye	ru#
Zeist	ne#
Zeist, Holland	ne#
Zeist, Netherlands	ne#
Zeist, The Netherlands	ne#
(Zoology)	xx#
Zu^urich	sz#
Zu^urich, Wien, Prag	sz#
(Zu^urich)	sz#
Zug, Switzerland	sz#
Zurich	sz#
(Zurich)	sz#
Zutphen, Netherlands	ne#
Athens	gr#
Aubenas	fr#
Aviemore	stk
Axbridge	enk
Bedminster	enk
Brattva^og	no#
British Columbia	bcc
Broomfield	enk
Charnay-les-Ma^hcon	fr#
Coimbra	po#
Collingwood, Vic	vra
Crawley	enk
Crawley, WA	wea
Cudham	enk
Easton	enk
Edinburgh of the Seven Seas	xj#
Elora, Ont	onc
Eva Pero^an La Plata	ag#
Faro	po#
[Flata^osen]	no#
Frentree Gully, Vic	vra
Geelong, Vic	vra
Grantchester	enk
Grantham	enk
Greenville, ME	meu
Irvine, CA	cau
Issaquah, WA	wau
Istanbul	tu#
Kingston, ACT	aca
Vache^gres	fr#
Lerici	it#
Livingston, NJ	nju
Manuka, ACT	aca
Marcinelle, Belgium	be#
Mumbai	ii#
NE Kirkland, WA	wau
Nekrasovka	ru#
New Castle, DE	deu
New Farm, Qld	qea
Newcastle, NSW	xna
Oldendorf	gw#
Olean, NY	nyu
Palma de Mallorca	sp#
Penryn	enk
Port Glasgow	stk
Porto	po#
Pune	ii#
Punta del Este	uy#
Redlikon	sz#
Ringwood, Vic	vra
Ro^zros, Norway	no#
Saint-Pierre, La Re^aunion	re#
Salenstein, Switzerland	sz#
Sandy Bay, Tas	tma
'S-Gravenhage	ne#
Slingerland, NY	nyu
Ste-Foy, Que	quc
Stevenage	enk
Stoke on Trent	enk
Stratford upon Avon	enk
Tewkesbury	enk
Underskoven	xx#
Uummannaq	gl#
West Chester, PA	pau
Westmount, Que.	quc
Kingston, Ont	onc
Kingston, Tas	tma
Melbourne, Vic	vra
Montgomery, AL	alu
Sankt peterburg	ru#
's-Gravenhage	ne#
's-Gravenhage, Netherlands	ne#
[Worthing]	enk
Cham, Switzerland	sz#
Research Triangle Park, NC	ncu
Charnay-Le^gs-Ma^hcon	fr#
Winterbourne	enk
Folkestone, Kent, UK	enk
Weissfluhjoch-Davos, Switzerland	sz#
Illnau	sz#
Mirny, Russia	ru#
Vienna, VA	vau
Que^abec	quc
Fort Chimo, Que^abec	quc
North Slope Borough	aku
Manali, India	ii#
Lavrentiya, Chukotka	ru#
Leningrad-Moskva	ru#
Richardson, TX	txu
Arbroath	stk
San Juan-Mendoza-San Luis, Argentina	ag#
North Adelaide, S.A.	xra
[Wroclaw]	pl#
Lincoln, MA	mau
[New Orleans, LA]	lau
St.-Pe^atersbourg	ru#
Warren, MI	miu
Pskov	ru#
Nakladem Uniwersytetu Jagielloskiego	pl#
[various]	xx#
Bussum	ne#
Kyiv	un#
Nijmegen	ne#
St. Petersburg (Petrograd/Leningrad)	ru#
Sydney, N.S.W.	xna
Pleasantville, N.Y	nyu
[Pleasantville, N.Y.]	nyu
London, Canada	onc
Oulu	fi
Orle^aans	fr#
[Granada]	sp#
[Maxwell Air Force Base, AL]	alu
Bilbao	sp#
verorne	sw#
Rognan	no#
Kakioka	ja#
Hampton, Vic	vra
[Sydney], NSW	xna
Newport, R.I.	riu
